"","occurrence","incidents","assault_count","robbery_count","precip","mean_temp","cool_deg_days","heat_deg_days","max_temp","min_temp","morn_inc","aft_inc","eve_inc","nuit_inc","incients"
"1",2014-01-01,171,168,3,0,-11.4555555555556,0,5036.9,-8.37777777777778,-14.4333333333333,11,16,18,20,65
"2",2014-01-02,28,24,4,1.92857142857143,-16.7821428571429,0,973.9,-14.2821428571429,-19.1857142857143,3,4,5,16,28
"3",2014-01-03,28,26,2,0.15,-14.575,0,912.1,-6.975,-22.175,7,8,8,5,28
"4",2014-01-04,43,40,3,0,-3.46511627906977,0,923,0.311627906976744,-7.15348837209302,13,4,12,14,43
"5",2014-01-05,56,48,8,11.4571428571429,-0.285714285714286,0,1024,1.37142857142857,-1.84285714285714,18,9,17,12,56
"6",2014-01-06,40,29,11,6.43,-6.685,0,987.4,2.425,-15.79,7,5,16,12,40
"7",2014-01-07,57,45,12,0.371929824561404,-18.9508771929825,0,2106.2,-15.7298245614035,-22.1649122807018,3,9,24,21,57
"8",2014-01-08,66,51,15,0,-11.9939393939394,0,1979.6,-7.7,-16.1878787878788,2,11,18,13,44
"9",2014-01-09,39,33,6,0,-7.41025641025641,0,991,-2.92820512820513,-11.7923076923077,5,10,16,8,39
"10",2014-01-10,45,32,13,2.14222222222222,-0.113333333333333,0,815.1,3.86888888888889,-4.17777777777778,4,9,11,21,45
"11",2014-01-11,53,46,7,9.68490566037736,4.84528301886792,0,697.2,6.94339622641509,2.73018867924528,22,4,15,12,53
"12",2014-01-12,52,43,9,0,2.30384615384615,0,816.2,3.26538461538462,1.26153846153846,18,4,7,23,52
"13",2014-01-13,41,34,7,0,4.56829268292683,0,550.7,7.20243902439024,1.84146341463415,3,13,12,13,41
"14",2014-01-14,49,38,11,0,3.22857142857143,0,723.8,5.19795918367347,1.24897959183673,9,12,16,12,49
"15",2014-01-15,46,39,7,0,-0.626086956521739,0,856.8,2.37391304347826,-3.53913043478261,7,8,17,14,46
"16",2014-01-16,44,35,9,0,-1.99090909090909,0,879.6,-0.390909090909091,-3.59090909090909,7,7,11,19,44
"17",2014-01-17,51,39,12,1.07058823529412,0.564705882352941,0,889.2,2.21176470588235,-1.16470588235294,8,7,17,19,51
"18",2014-01-18,68,63,5,0.426470588235294,-3.9,0,1489.2,-0.829411764705882,-6.88529411764706,23,8,17,20,68
"19",2014-01-19,45,38,7,0.88,-5.24,0,1045.8,-1.9,-8.52,18,2,12,13,45
"20",2014-01-20,44,35,9,0.772727272727273,-9.10909090909091,0,1192.8,-1.75454545454545,-16.3636363636364,10,6,11,17,44
"21",2014-01-21,38,27,11,0.407894736842105,-16.9263157894737,0,1327.2,-14.2736842105263,-19.5789473684211,5,7,14,12,38
"22",2014-01-22,36,27,9,0,-16.2555555555556,0,1233.2,-12.0666666666667,-20.4333333333333,4,9,18,5,36
"23",2014-01-23,35,34,1,0,-14.7885714285714,0,1147.6,-12.1885714285714,-17.3885714285714,4,9,17,5,35
"24",2014-01-24,40,33,7,0,-12.165,0,1206.6,-6.62,-17.6325,15,3,13,9,40
"25",2014-01-25,41,33,8,1.36585365853659,-8.24146341463415,0,1075.9,-2.71219512195122,-13.7707317073171,9,8,5,19,41
"26",2014-01-26,48,38,10,0.985416666666667,-9.12708333333333,0,1302.1,-3.71666666666667,-14.5270833333333,8,7,15,18,48
"27",2014-01-27,39,28,11,2.65641025641026,-9.86923076923077,0,1086.9,-3.66923076923077,-15.9692307692308,2,5,15,17,39
"28",2014-01-28,45,36,9,0.186666666666667,-15.06,0,1487.7,-11.5733333333333,-18.54,8,8,11,18,45
"29",2014-01-29,25,19,6,0,-12.78,0,769.5,-9.152,-16.308,4,1,11,9,25
"30",2014-01-30,54,43,11,0,-5.48333333333333,0,1268.1,-0.4,-10.5666666666667,14,7,17,16,54
"31",2014-01-31,68,51,17,0,-0.570588235294118,0,1262.8,1.45294117647059,-2.58235294117647,15,10,20,23,68
"32",2014-02-01,72,68,4,14.0625,0.075,0,1290.6,1.3625,-1.3,11,4,19,15,49
"33",2014-02-02,57,49,8,0.510526315789474,-2.6,0,1174.2,0.9,-6.07894736842105,23,7,11,16,57
"34",2014-02-03,56,50,6,0.157142857142857,-6.25,0,1358,-2.63571428571429,-9.76428571428571,5,9,19,23,56
"35",2014-02-04,51,44,7,0.758823529411765,-7.1843137254902,0,1284.4,-3.86862745098039,-10.4843137254902,6,14,25,6,51
"36",2014-02-05,45,32,13,9.68888888888889,-8.47777777777778,0,1191.5,-5.17777777777778,-11.6888888888889,2,5,22,16,45
"37",2014-02-06,41,35,6,0.439024390243902,-9.9,0,1143.9,-6.4390243902439,-13.2731707317073,3,7,12,19,41
"38",2014-02-07,44,37,7,0,-11.1545454545455,0,1282.8,-8.47272727272727,-13.8363636363636,7,7,15,15,44
"39",2014-02-08,45,34,11,0,-11.3777777777778,0,1322,-8.61111111111111,-14.1333333333333,12,3,11,19,45
"40",2014-02-09,47,37,10,1.60851063829787,-9.76382978723404,0,1304.9,-7.21063829787234,-12.2170212765957,18,5,7,17,47
"41",2014-02-10,53,43,10,0.277358490566038,-8.9,0,1425.7,-5.72264150943396,-11.977358490566,4,13,25,11,53
"42",2014-02-11,59,37,22,0,-11.235593220339,0,1724.9,-8.81016949152542,-13.6559322033898,4,12,29,14,59
"43",2014-02-12,39,25,14,0,-9.77179487179487,0,1083.1,-5.28205128205128,-14.1615384615385,5,8,14,12,39
"44",2014-02-13,71,56,15,0,-5.5169014084507,0,1669.7,-1.6887323943662,-9.34507042253521,13,16,17,25,71
"45",2014-02-14,59,47,12,0,-1.93050847457627,0,1175.9,0.638983050847458,-4.4,8,8,17,26,59
"46",2014-02-15,66,52,14,0,-7.21363636363636,0,1664.1,-2.48181818181818,-11.8590909090909,30,9,10,17,66
"47",2014-02-16,49,42,7,0,-9.83877551020408,0,1364.1,-6.93061224489796,-12.6469387755102,22,7,7,13,49
"48",2014-02-17,30,25,5,0.373333333333333,-8.18,0,785.4,-2.19333333333333,-14.16,10,3,10,7,30
"49",2014-02-18,50,40,10,5.358,-1.806,0,990.3,0.664,-4.182,3,11,18,18,50
"50",2014-02-19,62,50,12,0.324193548387097,2.90645161290323,0,935.8,7.51774193548387,-1.70483870967742,5,14,25,18,62
"51",2014-02-20,45,36,9,13.3733333333333,0.715555555555556,0,777.8,2.55555555555556,-1.12,11,3,16,15,45
"52",2014-02-21,44,32,12,8.71136363636364,2.87727272727273,0,665.4,4.99772727272727,0.745454545454545,5,4,19,16,44
"53",2014-02-22,50,35,15,0,1.86,0,807,4.08,-0.44,20,6,12,12,50
"54",2014-02-23,70,61,9,0,-1.76428571428571,0,1383.5,1.18571428571429,-4.63571428571429,21,7,26,16,70
"55",2014-02-24,46,38,8,0,-6.5695652173913,0,1130.2,-4.3,-8.73913043478261,5,5,27,9,46
"56",2014-02-25,49,42,7,0,-7.78367346938775,0,1263.4,-5.2,-10.3591836734694,3,10,26,10,49
"57",2014-02-26,43,36,7,0,-11.1348837209302,0,1252.8,-8.10697674418605,-14.153488372093,4,8,13,18,43
"58",2014-02-27,40,37,3,0.255,-12.11,0,1204.4,-8.18,-15.94,6,9,14,11,40
"59",2014-02-28,54,42,12,0,-12.2444444444444,0,1633.2,-6.88148148148148,-17.6074074074074,14,6,19,15,54
"60",2014-03-01,74,67,7,2.8972972972973,-5.53783783783784,0,1741.8,-0.785135135135135,-10.1905405405405,23,7,20,24,74
"61",2014-03-02,56,50,6,1.20535714285714,-12,0,1680,-8.53928571428571,-15.4607142857143,22,5,13,16,56
"62",2014-03-03,66,43,23,0.187878787878788,-14.6818181818182,0,2157,-10.9,-18.369696969697,10,13,27,16,66
"63",2014-03-04,40,29,11,0.585,-11.895,0,1195.8,-8.105,-15.5875,6,6,15,13,40
"64",2014-03-05,50,33,17,0.168,-7.616,0,1280.8,-4.716,-10.5,7,9,21,13,50
"65",2014-03-06,57,36,21,0,-5.75087719298246,0,1353.8,-2.9,-8.50175438596491,4,6,24,23,57
"66",2014-03-07,47,37,10,0.25531914893617,-1.34255319148936,0,909.1,2.73617021276596,-5.4063829787234,7,3,15,22,47
"67",2014-03-08,55,41,14,0,-1.7,0,1083.5,2.77454545454545,-6.17454545454545,16,5,18,16,55
"68",2014-03-09,56,49,7,0,-3.875,0,1225,1.375,-9.1125,21,9,12,14,56
"69",2014-03-10,53,47,6,0,3.94150943396226,0,745.1,6.63962264150943,1.15471698113208,4,7,23,19,53
"70",2014-03-11,43,35,8,0,6.92558139534884,0,476.2,10.1604651162791,3.5906976744186,12,6,11,14,43
"71",2014-03-12,38,26,12,10.3263157894737,-4.58684210526316,0,858.3,4.86052631578947,-13.9473684210526,6,1,16,15,38
"72",2014-03-13,42,37,5,0,-11.252380952381,0,1228.6,-6.04047619047619,-16.452380952381,11,2,10,19,42
"73",2014-03-14,46,38,8,0,1.98478260869565,0,736.7,9.99130434782609,-6.02173913043478,10,6,13,17,46
"74",2014-03-15,55,49,6,0,-0.6,0,1023,6.06727272727273,-7.26727272727273,23,11,9,12,55
"75",2014-03-16,44,35,9,0,-9.84545454545455,0,1225.2,-7.08636363636364,-12.5181818181818,11,10,11,12,44
"76",2014-03-17,54,40,14,0,-8.64444444444444,0,1438.8,-3.49074074074074,-13.6981481481481,2,5,22,25,54
"77",2014-03-18,53,39,14,0,-0.937735849056604,0,1003.7,1.90566037735849,-3.7,14,8,20,11,53
"78",2014-03-19,32,22,10,6.175,3.925,0,450.4,6.96875,0.7875,5,3,8,16,32
"79",2014-03-20,48,41,7,0,1.5,0,792,4.275,-1.275,4,13,14,17,48
"80",2014-03-21,39,34,5,0,0.179487179487179,0,695,2.76410256410256,-2.5,9,8,10,12,39
"81",2014-03-22,52,48,4,0.884615384615385,-1.24615384615385,0,1000.8,3.28461538461538,-5.7,15,9,12,16,52
"82",2014-03-23,53,46,7,0,-6.63396226415094,0,1305.6,-4.46981132075472,-8.79811320754717,22,5,4,22,53
"83",2014-03-24,36,31,5,0,-5.74166666666667,0,854.7,-1.99166666666667,-9.48333333333333,8,3,15,10,36
"84",2014-03-25,47,38,9,0,-3.7,0,1019.9,1.07446808510638,-8.38723404255319,10,4,21,12,47
"85",2014-03-26,45,37,8,0,-6.83555555555556,0,1117.6,-3.08888888888889,-10.5733333333333,4,11,16,14,45
"86",2014-03-27,49,38,11,0.679591836734694,-1.24897959183673,0,943.2,4.63673469387755,-7.11836734693878,5,7,16,21,49
"87",2014-03-28,39,31,8,2.51025641025641,6.46666666666667,0,449.8,10.025641025641,2.8974358974359,4,7,12,16,39
"88",2014-03-29,49,42,7,0,2.48775510204082,0,760.1,3.47551020408163,1.48775510204082,12,9,14,14,49
"89",2014-03-30,49,45,4,0,4.3734693877551,0,667.7,8.96734693877551,-0.220408163265306,20,6,11,12,49
"90",2014-03-31,36,31,5,0,5.7,0,442.8,9.9,1.4,4,10,9,13,36
"91",2014-04-01,93,83,10,0,6.5,0,1069.5,10.3,3.83225806451613,30,17,27,19,93
"92",2014-04-02,44,35,9,0,4.85454545454545,0,578.4,8.7,0.909090909090909,4,8,16,16,44
"93",2014-04-03,40,33,7,0.475,1.975,0,641,4.33,-0.48,5,4,26,5,40
"94",2014-04-04,53,47,6,11.3735849056604,4.67358490566038,0,706.3,7.22830188679245,2.06132075471698,8,7,20,18,53
"95",2014-04-05,45,39,6,0,2.32888888888889,0,705.2,4.87777777777778,-0.295555555555556,23,2,5,15,45
"96",2014-04-06,54,44,10,0,4.67777777777778,0,719.4,10.3962962962963,-1.12037037037037,17,3,20,14,54
"97",2014-04-07,41,33,8,14.4560975609756,5.77804878048781,0,501.1,8.59268292682927,2.87560975609756,7,6,14,14,41
"98",2014-04-08,40,31,9,5.67,8.17,0,393.2,13.63,2.71,1,8,19,12,40
"99",2014-04-09,52,41,11,0,6.27692307692308,0,609.6,10.3769230769231,2.07692307692308,9,3,13,27,52
"100",2014-04-10,58,52,6,0,10.3413793103448,0,444.2,17.0448275862069,3.63793103448276,14,7,18,19,58
"101",2014-04-11,40,28,12,0,9.86,0,325.6,13.81,5.91,7,4,14,15,40
"102",2014-04-12,63,43,20,3.03809523809524,9.38095238095238,0,543,13.8444444444444,4.91746031746032,17,9,19,18,63
"103",2014-04-13,49,43,6,4.75102040816327,11.130612244898,0,336.6,17.1755102040816,4.98571428571429,12,6,14,17,49
"104",2014-04-14,42,32,10,7.98333333333333,11.0166666666667,0,293.3,19.3,2.71666666666667,4,8,22,8,42
"105",2014-04-15,40,33,7,8.705,-0.795,0,751.8,2.8,-4.39,3,7,17,13,40
"106",2014-04-16,48,32,16,0,-0.61875,0,893.7,3.75625,-4.9875,11,10,21,6,48
"107",2014-04-17,53,43,10,0,3.99433962264151,0,742.3,7.28867924528302,0.613207547169811,4,6,22,21,53
"108",2014-04-18,45,38,7,0.213333333333333,7.16666666666667,0,487.5,11.2733333333333,2.97333333333333,19,3,7,16,45
"109",2014-04-19,46,40,6,0.182608695652174,6.43478260869565,0,532,11.6217391304348,1.24782608695652,11,8,15,12,46
"110",2014-04-20,50,40,10,0,7.44,0,528,11.142,3.738,10,8,15,17,50
"111",2014-04-21,35,26,9,0,12.4142857142857,0,195.5,18.3142857142857,6.41428571428571,5,4,12,14,35
"112",2014-04-22,47,40,7,3.5,10.0106382978723,0,375.5,14.9595744680851,4.97446808510638,5,8,16,18,47
"113",2014-04-23,50,40,10,0.048,6.248,0,587.6,9.364,3.116,6,7,21,16,50
"114",2014-04-24,56,43,13,0,6.875,0,623,11.8964285714286,1.85357142857143,7,11,26,12,56
"115",2014-04-25,48,37,11,2.56041666666667,7.62708333333333,0,497.9,10.46875,4.77083333333333,9,9,14,16,48
"116",2014-04-26,69,55,14,0.265217391304348,7.46521739130435,0,726.9,10.4579710144928,4.38405797101449,15,6,15,33,69
"117",2014-04-27,65,57,8,0,7.19692307692308,0,702.2,11.4261538461538,2.95076923076923,23,8,19,15,65
"118",2014-04-28,70,59,11,0,9.12857142857143,0,621,12.3428571428571,5.91428571428571,13,10,21,26,70
"119",2014-04-29,42,34,8,32.4571428571429,6.84523809523809,0,468.5,7.89761904761905,5.79285714285714,2,6,18,16,42
"120",2014-04-30,41,32,9,6.29268292682927,5.82682926829268,0,499.1,6.61219512195122,5.02682926829268,6,5,22,8,41
"121",2014-05-01,78,64,14,2.47435897435897,10.5435897435897,0,581.6,14.9358974358974,6.15128205128205,16,19,23,20,78
"122",2014-05-02,75,54,21,0.173333333333333,9.92666666666667,0,605.5,12.24,7.61333333333333,18,11,28,18,75
"123",2014-05-03,60,45,15,1.50666666666667,9.68666666666667,0,498.8,11.7466666666667,7.52666666666667,26,2,19,13,60
"124",2014-05-04,54,48,6,0.233333333333333,10.1777777777778,0,422.4,14.4333333333333,5.9,22,12,8,12,54
"125",2014-05-05,52,35,17,0,9.44615384615385,0,444.8,13.4653846153846,5.34038461538462,4,11,23,14,52
"126",2014-05-06,53,45,8,0,10.6716981132075,0,388.4,13.9867924528302,7.35660377358491,8,7,14,24,53
"127",2014-05-07,48,41,7,0.1625,9.81875,0,392.7,12.44375,7.175,7,16,11,14,48
"128",2014-05-08,68,51,17,0,13.7808823529412,0,286.9,17.8897058823529,9.66764705882353,9,9,20,16,54
"129",2014-05-09,70,55,15,0.371428571428571,15.0857142857143,0,204,19.7714285714286,10.3142857142857,7,11,28,24,70
"130",2014-05-10,56,44,12,0.178571428571429,16.1964285714286,0,101,21.2035714285714,11.1785714285714,11,6,11,28,56
"131",2014-05-11,59,51,8,0,14.9661016949153,0,179,21.0254237288136,8.80677966101695,20,11,14,14,59
"132",2014-05-12,64,52,12,0.31875,16.40625,0,102,20.1859375,12.5265625,10,9,26,19,64
"133",2014-05-13,55,42,13,5.9,15.1,0,159.5,18.9,11.2,3,10,32,10,55
"134",2014-05-14,73,62,11,14.4109589041096,16.9794520547945,0,74.5,20.4,13.4643835616438,8,13,25,27,73
"135",2014-05-15,54,49,5,11.0851851851852,15.2851851851852,0,146.6,20.5555555555556,10.0148148148148,3,12,19,20,54
"136",2014-05-16,44,33,11,3.06590909090909,9.44318181818182,0,376.5,13.375,5.42272727272727,10,7,11,16,44
"137",2014-05-17,66,53,13,0,7.94848484848485,0,663.4,11.6363636363636,4.16060606060606,21,13,21,11,66
"138",2014-05-18,49,41,8,0.973469387755102,10.1612244897959,0,384.1,14.7877551020408,5.43469387755102,21,6,11,11,49
"139",2014-05-19,60,47,13,0.366666666666667,14.5833333333333,0,205,20.9833333333333,8.09166666666667,8,12,12,28,60
"140",2014-05-20,64,47,17,0.9375,15.846875,0,137.8,19.203125,12.4,3,8,26,27,64
"141",2014-05-21,40,33,7,0.24,15.12,0,115.2,19.1,11.14,5,4,12,19,40
"142",2014-05-22,61,46,15,0,16.0245901639344,0,120.5,21.6606557377049,10.7327868852459,11,8,23,19,61
"143",2014-05-23,38,30,8,0,14.0578947368421,0,149.8,17.5210526315789,10.5842105263158,16,7,4,11,38
"144",2014-05-24,63,56,7,0,16.8174603174603,0,74.5,22.8015873015873,10.8587301587302,26,6,15,16,63
"145",2014-05-25,73,68,5,0,17.6315068493151,0.556164383561644,67.5,23.8,11.5041095890411,11,11,8,18,48
"146",2014-05-26,46,41,5,0.173913043478261,22.8086956521739,4.80869565217391,0,29.9173913043478,15.6,7,4,20,15,46
"147",2014-05-27,60,49,11,4.855,22.1,4.1,0,25.885,18.22,6,12,19,23,60
"148",2014-05-28,79,57,22,0,15.3658227848101,0,208.1,17.0278481012658,13.6151898734177,15,9,23,20,67
"149",2014-05-29,55,44,11,0,15.0545454545455,0,162,17.3890909090909,12.6981818181818,7,12,24,12,55
"150",2014-05-30,61,44,17,0,18.6049180327869,0.767213114754098,9.9,24.9016393442623,12.3081967213115,8,6,14,33,61
"151",2014-05-31,75,63,12,0,18.82,0.852,2.4,22.4306666666667,15.2093333333333,18,11,17,29,75
"152",2014-06-01,78,73,5,0.164102564102564,17,0,78,21.7153846153846,12.2025641025641,29,11,23,15,78
"153",2014-06-02,43,34,9,0.255813953488372,20.2837209302326,2.28372093023256,0,26.3883720930233,14.0790697674419,8,6,11,18,43
"154",2014-06-03,55,45,10,5.62909090909091,21.0363636363636,3.03636363636364,0,27.4109090909091,14.5618181818182,10,3,19,23,55
"155",2014-06-04,39,36,3,0,18.2564102564103,0.256410256410256,0,23.225641025641,12.9923076923077,7,3,14,15,39
"156",2014-06-05,60,50,10,0,15.3133333333333,0,161.2,18.5266666666667,12.1,5,8,31,16,60
"157",2014-06-06,52,44,8,0,17.8076923076923,0,10,23.6846153846154,11.8307692307692,12,9,11,20,52
"158",2014-06-07,76,69,7,0,19.0052631578947,1.02631578947368,1.6,24.8894736842105,13.0210526315789,23,7,21,25,76
"159",2014-06-08,71,64,7,0.169014084507042,18.0295774647887,0.169014084507042,9.9,20.4845070422535,15.5746478873239,21,10,18,22,71
"160",2014-06-09,68,55,13,0.167647058823529,20.7058823529412,2.70588235294118,0,25.5955882352941,15.7323529411765,9,9,29,21,68
"161",2014-06-10,70,60,10,0,19.9228571428571,2.03714285714286,8,23.3571428571429,16.3885714285714,12,6,28,24,70
"162",2014-06-11,69,57,12,17.4434782608696,19.2434782608696,1.33913043478261,6.6,22.6869565217391,15.704347826087,9,17,15,28,69
"163",2014-06-12,53,47,6,0.713207547169811,20.6396226415094,2.63962264150943,0,24.9018867924528,16.277358490566,11,5,24,13,53
"164",2014-06-13,51,42,9,0,18.7607843137255,0.76078431372549,0,24.7313725490196,12.7,12,10,12,17,51
"165",2014-06-14,54,48,6,0,15.9222222222222,0,112.2,20.2666666666667,11.5555555555556,14,7,7,26,54
"166",2014-06-15,70,61,9,0.174285714285714,16.3328571428571,0,116.7,20.2685714285714,12.2971428571429,30,4,13,23,70
"167",2014-06-16,57,45,12,0.456140350877193,18.419298245614,0.63859649122807,12.5,22.8701754385965,13.9684210526316,3,11,20,23,57
"168",2014-06-17,65,55,10,24.16,21.12,3.12,0,26.68,15.54,8,10,28,19,65
"169",2014-06-18,46,40,6,0.0326086956521739,21.1760869565217,3.17608695652174,0,23.8608695652174,18.3913043478261,0,11,23,12,46
"170",2014-06-19,55,44,11,0.610909090909091,20.1345454545455,2.13454545454545,0,23.5072727272727,16.7618181818182,5,8,26,16,55
"171",2014-06-20,64,49,15,0.19375,18.55,0.58125,2,21.534375,15.46875,5,14,23,22,64
"172",2014-06-21,75,59,16,0,19.6013333333333,1.60133333333333,0,22.92,16.2013333333333,21,10,19,25,75
"173",2014-06-22,65,56,9,0.184615384615385,20.0769230769231,2.07692307692308,0,25.6384615384615,14.5153846153846,18,7,16,24,65
"174",2014-06-23,54,45,9,2.86481481481481,20.4055555555556,2.40555555555556,0,23.7111111111111,17.012962962963,9,11,11,23,54
"175",2014-06-24,61,52,9,2.6327868852459,22.9868852459016,4.98688524590164,0,27.7032786885246,18.1704918032787,9,10,18,24,61
"176",2014-06-25,51,37,14,32.7666666666667,21.3901960784314,3.39019607843137,0,23.6372549019608,19.143137254902,15,6,14,16,51
"177",2014-06-26,64,55,9,0.178125,22.8015625,4.8015625,0,26.7921875,18.8109375,12,19,15,18,64
"178",2014-06-27,61,51,10,0.19016393442623,22.2868852459016,4.28688524590164,0,26.927868852459,17.5459016393443,11,6,15,29,61
"179",2014-06-28,80,72,8,0.40625,24.05625,6.05625,0,27.75,20.34375,23,12,15,30,80
"180",2014-06-29,67,53,14,6.9089552238806,25.1850746268657,7.18507462686567,0,29.5671641791045,20.7208955223881,20,5,15,27,67
"181",2014-06-30,58,50,8,0,25.1068965517241,7.10689655172414,0,28.8586206896552,21.2551724137931,16,4,23,15,58
"182",2014-07-01,86,74,12,1.3953488372093,26.3604651162791,8.36046511627907,0,30.2023255813953,22.4255813953488,28,13,20,25,86
"183",2014-07-02,48,42,6,0,24.19375,6.19375,0,28.76875,19.5375,10,4,17,17,48
"184",2014-07-03,59,52,7,0.588135593220339,18.564406779661,0.58135593220339,1,23.2118644067797,13.8169491525424,13,9,11,26,59
"185",2014-07-04,47,41,6,0,18.6170212765957,0.617021276595745,0,24.3170212765957,12.9170212765957,13,6,11,17,47
"186",2014-07-05,59,49,10,0,20.9627118644068,2.96271186440678,0,26.7169491525424,15.1084745762712,21,8,15,15,59
"187",2014-07-06,60,51,9,0,21.42,3.42,0,26.1,16.66,26,4,12,18,60
"188",2014-07-07,41,36,5,10.490243902439,23.1195121951219,5.11951219512195,0,28.2536585365854,17.9853658536585,5,9,12,15,41
"189",2014-07-08,33,28,5,17.9606060606061,20.0242424242424,2.06666666666667,1.4,23.5848484848485,16.3636363636364,6,5,9,13,33
"190",2014-07-09,54,44,10,0.348148148148148,19.2148148148148,1.30555555555556,4.9,23.2092592592593,15.2074074074074,8,6,16,24,54
"191",2014-07-10,52,44,8,0,17.3057692307692,0,36.1,21.8576923076923,12.6538461538462,11,10,15,16,52
"192",2014-07-11,49,41,8,0,19.2918367346939,1.42244897959184,6.4,24.1285714285714,14.3551020408163,8,9,16,16,49
"193",2014-07-12,76,64,12,0,22.1368421052632,4.13684210526316,0,27.7631578947368,16.5105263157895,27,8,15,26,76
"194",2014-07-13,68,52,16,6.49411764705882,24.7661764705882,6.76617647058824,0,29.4588235294118,19.9735294117647,14,7,15,32,68
"195",2014-07-14,43,38,5,0,19.5209302325581,1.54883720930233,1.2,22.0627906976744,16.9651162790698,9,4,17,13,43
"196",2014-07-15,45,36,9,5.83333333333333,20.3866666666667,2.38666666666667,0,25.1666666666667,15.6,4,6,16,19,45
"197",2014-07-16,51,45,6,2.8843137254902,17.6411764705882,0,18.3,21.0843137254902,14.1019607843137,7,10,16,18,51
"198",2014-07-17,69,50,19,0.168115942028986,17.1884057971014,0,56,22.6927536231884,11.668115942029,6,13,31,19,69
"199",2014-07-18,63,56,7,0,18.5380952380952,0.571428571428571,2.1,24.3047619047619,12.6761904761905,6,6,18,33,63
"200",2014-07-19,56,45,11,7.26785714285714,18.9589285714286,1.00714285714286,2.7,20.5946428571429,17.3071428571429,14,8,15,19,56
"201",2014-07-20,54,44,10,0.224074074074074,20.8351851851852,2.83518518518519,0,24.062962962963,17.6074074074074,23,7,11,13,54
"202",2014-07-21,61,49,12,0.183606557377049,22.3360655737705,4.33606557377049,0,27.5770491803279,17.0032786885246,7,13,22,19,61
"203",2014-07-22,47,43,4,1.11702127659574,23.936170212766,5.93617021276596,0,29.3106382978723,18.5617021276596,11,9,11,16,47
"204",2014-07-23,45,37,8,0.806666666666667,20.7688888888889,2.76888888888889,0,24.46,17.0777777777778,13,8,14,10,45
"205",2014-07-24,41,32,9,0.185365853658537,18.7560975609756,0.75609756097561,0,22.4536585365854,15.0512195121951,10,3,12,16,41
"206",2014-07-25,49,40,9,0,19.369387755102,1.36938775510204,0,24.5918367346939,14.0469387755102,5,8,15,21,49
"207",2014-07-26,93,60,33,0,21.3462365591398,3.34623655913978,0,25.5516129032258,17.0408602150538,11,8,24,19,62
"208",2014-07-27,52,39,13,7.92692307692308,23.7846153846154,5.78461538461539,0,29.1807692307692,18.3826923076923,19,5,10,18,52
"209",2014-07-28,51,40,11,13.8686274509804,18.5352941176471,0.535294117647059,0,21.7137254901961,15.3352941176471,17,2,9,23,51
"210",2014-07-29,37,29,8,0.732432432432432,17.7567567567568,0,9,21.4918918918919,14.0162162162162,11,3,8,15,37
"211",2014-07-30,33,25,8,5.08181818181818,19.0454545454545,1.09090909090909,1.5,23.4090909090909,14.6818181818182,13,5,8,7,33
"212",2014-07-31,52,43,9,0,20.0615384615385,2.06153846153846,0,25.0384615384615,15.0846153846154,13,11,7,21,52
"213",2014-08-01,61,60,1,0,22.1622950819672,4.16229508196721,0,27.3508196721311,16.9622950819672,28,4,13,16,61
"214",2014-08-02,65,58,7,0,21.3046153846154,3.30461538461538,0,25.5046153846154,17.1046153846154,27,10,11,17,65
"215",2014-08-03,59,53,6,0,22.8322033898305,4.83220338983051,0,26.0677966101695,19.4966101694915,22,8,11,18,59
"216",2014-08-04,61,52,9,1.92459016393443,21.9868852459016,3.98688524590164,0,25.5344262295082,18.3393442622951,24,5,15,17,61
"217",2014-08-05,50,42,8,0,20.724,2.724,0,23.976,17.372,14,7,13,16,50
"218",2014-08-06,37,33,4,0,21.3189189189189,3.31891891891892,0,25.8054054054054,16.8243243243243,5,7,18,7,37
"219",2014-08-07,50,40,10,0,21.13,3.13,0,25.394,16.772,5,4,12,29,50
"220",2014-08-08,54,47,7,0,20.8055555555556,2.80555555555556,0,25.2537037037037,16.3574074074074,10,11,15,18,54
"221",2014-08-09,53,48,5,0,21.2962264150943,3.29622641509434,0,25.8622641509434,16.6471698113208,19,6,10,18,53
"222",2014-08-10,75,62,13,0,21.6386666666667,3.63866666666667,0,26.196,17.0626666666667,11,6,12,22,51
"223",2014-08-11,42,33,9,1.41666666666667,20.702380952381,2.70238095238095,0,24.2952380952381,19.9285714285714,11,4,8,19,42
"224",2014-08-12,46,41,5,1.18695652173913,20.7086956521739,2.70869565217391,0,24.3434782608696,17.1173913043478,8,8,16,14,46
"225",2014-08-13,54,43,11,0,20.262962962963,2.26296296296296,0,24.0074074074074,16.5611111111111,13,6,19,16,54
"226",2014-08-14,36,28,8,0,16.0166666666667,0,71.4,18.8,13.2333333333333,4,13,13,6,36
"227",2014-08-15,47,36,11,0,18.2148936170213,0.274468085106383,2.8,23.4085106382979,13.0212765957447,7,4,8,28,47
"228",2014-08-16,58,54,4,0.731034482758621,16.8551724137931,0,66.4,20.2758620689655,13.4241379310345,20,4,19,15,58
"229",2014-08-17,65,58,7,0,18.1907692307692,0.470769230769231,18.2,22.42,13.9615384615385,22,10,16,17,65
"230",2014-08-18,46,38,8,0,17.195652173913,0,37,20.404347826087,13.9782608695652,13,10,11,12,46
"231",2014-08-19,48,42,6,0,17.50625,0,23.7,21.4708333333333,13.4416666666667,3,2,20,23,48
"232",2014-08-20,60,47,13,0.726666666666667,20.7333333333333,2.73333333333333,0,23.9666666666667,17.5,16,12,10,22,60
"233",2014-08-21,52,40,12,5.71153846153846,21.8307692307692,3.83076923076923,0,25.8846153846154,17.6769230769231,6,3,16,27,52
"234",2014-08-22,57,49,8,0,21.1105263157895,3.11052631578947,0,24.4754385964912,17.7263157894737,10,7,17,23,57
"235",2014-08-23,59,49,10,0,20.4881355932203,2.48813559322034,0,21.6440677966102,19.2322033898305,18,12,15,14,59
"236",2014-08-24,73,66,7,0,21.1150684931507,3.11506849315068,0,23.7835616438356,18.3684931506849,30,5,19,19,73
"237",2014-08-25,57,57,0,0,22.5210526315789,4.52105263157895,0,27.1052631578947,17.9210526315789,11,13,11,22,57
"238",2014-08-26,46,37,9,0,24.195652173913,6.19565217391304,0,29.5434782608696,18.8478260869565,6,10,12,18,46
"239",2014-08-27,50,36,14,0,19.864,1.864,0,24.948,14.68,11,4,12,23,50
"240",2014-08-28,56,51,5,0,18.2428571428571,0.242857142857143,0,22.9,13.4857142857143,7,12,16,21,56
"241",2014-08-29,54,50,4,0,17.8666666666667,0,7.2,21.9388888888889,13.7,17,8,9,20,54
"242",2014-08-30,67,56,11,1.31940298507463,23.0208955223881,5.02089552238806,0,27.3164179104478,18.6402985074627,22,6,18,21,67
"243",2014-08-31,76,68,8,0,25.2118421052632,7.21184210526316,0,29.4118421052632,20.9118421052632,27,6,21,22,76
"244",2014-09-01,100,89,11,1.104,23.828,5.828,0,27.612,19.952,11,11,19,29,70
"245",2014-09-02,57,46,11,13.2368421052632,20.5894736842105,2.58947368421053,0,24.6315789473684,16.5368421052632,5,13,13,26,57
"246",2014-09-03,62,52,10,0,20.8661290322581,2.86612903225806,0,26.3532258064516,15.3790322580645,8,11,14,29,62
"247",2014-09-04,49,41,8,0,23.3510204081633,5.35102040816327,0,28.9510204081633,17.6510204081633,8,6,20,15,49
"248",2014-09-05,54,39,15,27.0111111111111,24.6111111111111,6.61111111111111,0,29.3333333333333,19.7888888888889,5,6,15,28,54
"249",2014-09-06,85,73,12,2.3,18.0705882352941,0.0705882352941176,0,22.0282352941176,14.0270588235294,17,7,24,19,67
"250",2014-09-07,70,58,12,0,16.7171428571429,0,89.8,20.68,12.7542857142857,28,7,14,21,70
"251",2014-09-08,44,30,14,0,17.9340909090909,0.0227272727272727,3.9,21.8977272727273,13.9590909090909,7,6,13,18,44
"252",2014-09-09,62,49,13,0,19.9741935483871,1.9741935483871,0,21.5483870967742,18.3935483870968,13,10,17,22,62
"253",2014-09-10,38,30,8,13.9315789473684,20.5578947368421,2.55789473684211,0,22.7,18.4157894736842,6,6,17,9,38
"254",2014-09-11,49,46,3,1.76122448979592,16.5795918367347,0,69.6,22.5591836734694,10.5,4,4,22,19,49
"255",2014-09-12,47,33,14,0,13.0829787234043,0,231.1,15.8744680851064,10.2914893617021,6,4,12,25,47
"256",2014-09-13,63,52,11,0.614285714285714,11.4904761904762,0,410.1,14.847619047619,8.13333333333333,22,8,11,22,63
"257",2014-09-14,51,40,11,0,11.4509803921569,0,334,15.7705882352941,7.04117647058824,15,7,19,10,51
"258",2014-09-15,54,47,7,5.45555555555555,14.2592592592593,0,202,18.1703703703704,10.3481481481481,11,12,18,13,54
"259",2014-09-16,66,54,12,0,14.4681818181818,0,233.1,18.9530303030303,9.98333333333333,8,10,30,18,66
"260",2014-09-17,57,49,8,0,14.7,0,188.1,20.2894736842105,9.09824561403509,7,8,19,23,57
"261",2014-09-18,49,38,11,0,11.865306122449,0,300.6,15.3285714285714,8.38367346938776,9,6,20,14,49
"262",2014-09-19,65,47,18,0,10.4384615384615,0,491.5,14.2415384615385,6.54923076923077,15,15,16,19,65
"263",2014-09-20,78,61,17,0.846153846153846,17.3833333333333,0,48.1,23.4846153846154,11.1910256410256,21,14,22,21,78
"264",2014-09-21,68,56,12,21.3352941176471,17.4779411764706,0,35.5,24.6117647058824,10.3441176470588,32,7,15,14,68
"265",2014-09-22,37,29,8,0,12.3486486486486,0,209.1,15.272972972973,9.42432432432432,5,8,13,11,37
"266",2014-09-23,56,49,7,0,15.5517857142857,0,137.1,21.9660714285714,9.0375,1,14,11,30,56
"267",2014-09-24,53,45,8,0,17.3641509433962,0,33.7,22.6037735849057,12.0339622641509,9,5,19,20,53
"268",2014-09-25,55,42,13,0,17.24,0,41.8,20.9527272727273,13.4272727272727,7,14,19,15,55
"269",2014-09-26,71,57,14,0,17.3338028169014,0,47.3,22.3323943661972,12.2478873239437,9,9,26,27,71
"270",2014-09-27,62,54,8,0,18.4225806451613,0.451612903225806,1.8,24.1870967741935,12.658064516129,22,6,16,18,62
"271",2014-09-28,87,73,14,0,19.4793103448276,1.47931034482759,0,24.5931034482759,14.351724137931,29,10,20,28,87
"272",2014-09-29,67,55,12,0,19.3880597014925,1.42089552238806,2.2,23.8059701492537,14.9537313432836,12,9,26,20,67
"273",2014-09-30,69,48,21,0,17.6202898550725,0,26.2,19.2202898550725,15.936231884058,8,13,27,21,69
"274",2014-10-01,95,81,14,0,15.8115789473684,0,207.9,16.6115789473684,14.9115789473684,28,9,18,27,82
"275",2014-10-02,43,38,5,0,16.7720930232558,0,52.8,18.3441860465116,15.1860465116279,6,8,13,16,43
"276",2014-10-03,59,41,18,7.40169491525424,18.6,0.6,0,22.0983050847458,15.0813559322034,14,8,20,17,59
"277",2014-10-04,58,49,9,2.44137931034483,10.6413793103448,0,426.8,15.2206896551724,5.97241379310345,25,9,16,8,58
"278",2014-10-05,67,57,10,0,9.49402985074627,0,569.9,13.9970149253731,4.8910447761194,21,6,15,25,67
"279",2014-10-06,59,53,6,0.672881355932203,13.6135593220339,0,258.8,17,10.1338983050847,6,11,25,17,59
"280",2014-10-07,61,50,11,14.9311475409836,14.5540983606557,0,210.2,17.6344262295082,11.3803278688525,16,10,22,13,61
"281",2014-10-08,43,26,17,0.406976744186047,10.706976744186,0,313.6,14.2558139534884,7.25116279069767,12,5,12,14,43
"282",2014-10-09,51,42,9,0,10.1235294117647,0,401.7,14.5882352941176,5.52352941176471,8,13,17,13,51
"283",2014-10-10,65,59,6,0,9.84307692307692,0,530.2,13.8430769230769,5.83230769230769,16,8,8,33,65
"284",2014-10-11,68,49,19,0,9.45882352941176,0,580.8,14.7588235294118,4.05882352941176,24,6,14,24,68
"285",2014-10-12,47,39,8,0,7.96808510638298,0,471.5,12.1340425531915,3.72978723404255,16,6,15,10,47
"286",2014-10-13,36,24,12,0,12.2666666666667,0,206.4,15.9444444444444,8.57777777777778,12,4,11,9,36
"287",2014-10-14,75,58,17,0.0746666666666667,18.2853333333333,0.453333333333333,12.6,22.0666666666667,14.504,5,11,25,34,75
"288",2014-10-15,47,33,14,2.87446808510638,16.1212765957447,0,88.3,18.6914893617021,13.4574468085106,7,6,15,19,47
"289",2014-10-16,49,39,10,20.5979591836735,15.6081632653061,0,117.2,18.5142857142857,12.6081632653061,9,12,18,10,49
"290",2014-10-17,79,48,31,0,13.9632911392405,0,318.9,16.2392405063291,11.6050632911392,7,8,32,32,79
"291",2014-10-18,67,45,22,0,9.08208955223881,0,597.5,13.7462686567164,4.4089552238806,19,4,24,20,67
"292",2014-10-19,82,65,17,0,6.07317073170732,0,978,9.13292682926829,3.01341463414634,30,9,20,23,82
"293",2014-10-20,45,35,10,7.28444444444444,8.95777777777778,0,406.9,11.3111111111111,6.60444444444444,6,3,14,22,45
"294",2014-10-21,49,34,15,2.04285714285714,9.34081632653061,0,424.3,11.5408163265306,7.06122448979592,8,7,16,18,49
"295",2014-10-22,48,34,14,0,9.35,0,415.2,13.5375,5.15,8,14,13,13,48
"296",2014-10-23,64,53,11,0,11.5703125,0,411.5,16.6703125,6.4703125,6,10,16,32,64
"297",2014-10-24,41,33,8,0,9.35121951219512,0,354.6,12.8024390243902,5.9,8,6,13,14,41
"298",2014-10-25,66,45,21,0,12.8409090909091,0,340.5,16.5393939393939,9.04242424242424,21,9,10,26,66
"299",2014-10-26,41,35,6,0,8.83414634146341,0,375.8,12.4536585365854,5.11463414634146,14,6,7,14,41
"300",2014-10-27,69,58,11,0.0434782608695652,7.89855072463768,0,697,11.7550724637681,4.04202898550725,7,11,30,21,69
"301",2014-10-28,51,40,11,1.32352941176471,15.3803921568627,0,133.6,20.143137254902,10.5313725490196,1,12,17,21,51
"302",2014-10-29,49,42,7,0.175510204081633,10.2632653061224,0,379.1,13.8510204081633,6.57551020408163,2,9,21,17,49
"303",2014-10-30,51,36,15,0,7,0,561,9.46470588235294,4.44705882352941,9,7,22,13,51
"304",2014-10-31,85,55,30,12.8470588235294,4.91882352941176,0,1111.9,7.6,2.13764705882353,13,11,19,19,62
"305",2014-11-01,118,107,11,2.19406779661017,2.08474576271186,0,1878,4.1271186440678,-0.0364406779661017,11,17,10,23,61
"306",2014-11-02,69,60,9,0.171014492753623,3.24347826086957,0,1018.2,7.51594202898551,-1.11449275362319,19,6,19,25,69
"307",2014-11-03,65,52,13,0.453846153846154,8.61692307692308,0,609.9,13.5707692307692,3.66307692307692,5,9,14,26,54
"308",2014-11-04,55,46,9,4,11.2,0,374,13.2,9.1,7,8,29,11,55
"309",2014-11-05,74,62,12,0,8.21486486486486,0,724.1,10.5121621621622,5.82972972972973,6,8,33,27,74
"310",2014-11-06,43,36,7,4.11395348837209,7.30697674418605,0,459.8,9.39302325581395,5.12093023255814,9,12,11,11,43
"311",2014-11-07,43,35,8,0.627906976744186,2.21395348837209,0,678.8,5.02790697674419,-0.693023255813953,2,15,12,14,43
"312",2014-11-08,54,44,10,0.966666666666667,3.68333333333333,0,773.1,7.31666666666667,-0.05,17,6,12,19,54
"313",2014-11-09,68,52,16,0,5.27352941176471,0,865.4,7.87352941176471,2.66029411764706,29,4,12,23,68
"314",2014-11-10,49,41,8,0.3,7.58163265306122,0,510.5,9.56938775510204,5.49387755102041,10,11,16,12,49
"315",2014-11-11,55,44,11,0.2,9.51818181818182,0,466.5,14.0727272727273,4.95454545454546,7,12,19,17,55
"316",2014-11-12,59,44,15,0.183050847457627,5.3,0,749.3,9.38305084745763,1.20847457627119,7,9,33,10,59
"317",2014-11-13,50,42,8,0.328,0.1,0,895,1.918,-1.736,7,7,16,20,50
"318",2014-11-14,55,41,14,0.178181818181818,-0.134545454545455,0,997.4,2.58727272727273,-2.85636363636364,12,12,11,20,55
"319",2014-11-15,77,58,19,0,0.0701298701298701,0,1380.6,3.65844155844156,-3.52987012987013,32,9,15,21,77
"320",2014-11-16,51,43,8,1.50588235294118,-0.1,0,923.1,0.688235294117647,-0.8,22,1,17,11,51
"321",2014-11-17,41,35,6,7.80975609756098,-1.5780487804878,0,802.7,1.90731707317073,-4.97073170731707,4,9,5,23,41
"322",2014-11-18,65,51,14,0.178461538461538,-5.63538461538462,0,1536.3,-3.34615384615385,-7.92461538461538,9,13,24,19,65
"323",2014-11-19,41,33,8,2.52682926829268,-4.05121951219512,0,904.1,0.0585365853658537,-8.07073170731707,8,10,16,7,41
"324",2014-11-20,38,33,5,0,-3.77631578947368,0,827.5,-1.49210526315789,-5.96842105263158,1,14,14,9,38
"325",2014-11-21,65,55,10,0.172307692307692,-6.54307692307692,0,1595.3,-1.03076923076923,-11.9553846153846,11,14,21,19,65
"326",2014-11-22,63,53,10,1.35714285714286,1.57142857142857,0,1035,6.95714285714286,-3.82857142857143,16,10,16,21,63
"327",2014-11-23,64,56,8,1.7921875,6.8546875,0,713.3,8.703125,4.9765625,21,5,19,19,64
"328",2014-11-24,40,33,7,13.3175,8.5875,0,376.5,13.485,3.68125,5,14,13,8,40
"329",2014-11-25,48,40,8,0,3.03125,0,718.5,4.62083333333333,1.34166666666667,4,14,18,12,48
"330",2014-11-26,49,43,6,0.179591836734694,2.29795918367347,0,769.4,5.08367346938776,1.21836734693878,6,12,17,14,49
"331",2014-11-27,49,41,8,0.0816326530612245,-0.179591836734694,0,890.8,2.92040816326531,-3.27959183673469,5,9,16,19,49
"332",2014-11-28,51,46,5,0,-3.7,0,1106.7,-1.81176470588235,-5.5,11,6,14,20,51
"333",2014-11-29,56,50,6,0,2.31964285714286,0,878.1,7.72321428571429,-3.1,19,9,5,23,56
"334",2014-11-30,49,46,3,0.0612244897959184,8.07551020408163,0,486.3,11.530612244898,4.52040816326531,21,2,14,12,49
"335",2014-12-01,61,58,3,0,-0.604918032786885,0,1134.9,4.6,-5.80491803278689,17,6,21,17,61
"336",2014-12-02,43,40,3,0.190697674418605,-3.08604651162791,0,906.7,2.5093023255814,-8.68139534883721,2,5,19,17,43
"337",2014-12-03,52,46,6,0.571153846153846,1.33846153846154,0,866.4,3.23846153846154,-0.571153846153846,8,8,23,13,52
"338",2014-12-04,46,28,18,0,-1.43478260869565,0,894,0.297826086956522,-3.07391304347826,11,10,9,16,46
"339",2014-12-05,54,49,5,0,0.959259259259259,0,920.2,3.9,-2.08148148148148,13,5,18,18,54
"340",2014-12-06,57,50,7,0,2.67368421052632,0,873.6,6.14912280701754,-0.826315789473684,11,9,16,21,57
"341",2014-12-07,65,52,13,0,-3.14923076923077,0,1374.7,-0.566153846153846,-5.73230769230769,29,7,7,22,65
"342",2014-12-08,57,44,13,0,1.86315789473684,0,919.8,4.73859649122807,-1.1,10,12,17,18,57
"343",2014-12-09,48,36,12,0.0625,3.175,0,711.6,5.2125,1.125,15,3,12,18,48
"344",2014-12-10,37,32,5,0,-1.47567567567568,0,720.6,1.3,-4.15945945945946,5,8,15,9,37
"345",2014-12-11,56,47,9,15.4285714285714,-3.84285714285714,0,1223.2,-2.32857142857143,-5.35714285714286,16,5,13,22,56
"346",2014-12-12,46,41,5,2.34782608695652,-0.0130434782608696,0,828.6,3.06521739130435,-3.01304347826087,7,5,18,16,46
"347",2014-12-13,53,45,8,0,2.15471698113208,0,839.8,2.77735849056604,1.45471698113208,16,8,16,13,53
"348",2014-12-14,65,54,11,0.210769230769231,3.4,0,949,4.33230769230769,2.36769230769231,20,9,12,24,65
"349",2014-12-15,43,38,5,0,3.86279069767442,0,607.9,4.46279069767442,3.24418604651163,11,9,9,14,43
"350",2014-12-16,56,52,4,4.36964285714286,3.67857142857143,0,802,5.25714285714286,2.1,16,10,20,10,56
"351",2014-12-17,60,46,14,5.25333333333333,2.97333333333333,0,901.6,5.82,0.0266666666666667,19,7,16,18,60
"352",2014-12-18,57,41,16,0,-1.7859649122807,0,1127.8,0.7,-4.17894736842105,8,9,25,15,57
"353",2014-12-19,45,38,7,0,-2.46444444444444,0,920.9,0.153333333333333,-4.98222222222222,9,7,9,20,45
"354",2014-12-20,47,40,7,0,-2.47021276595745,0,962.1,-0.170212765957447,-4.67021276595745,17,2,15,13,47
"355",2014-12-21,67,59,8,0,0.746268656716418,0,1156,3.06417910447761,-1.66567164179104,26,7,16,18,67
"356",2014-12-22,47,37,10,0,1.49787234042553,0,775.6,2.29148936170213,-0.831914893617021,6,6,15,20,47
"357",2014-12-23,53,45,8,0,4.42075471698113,0,719.7,6.87547169811321,1.87735849056604,7,8,13,25,53
"358",2014-12-24,49,43,6,7.8469387755102,7.89795918367347,0,495,10.3244897959184,5.47142857142857,13,12,10,14,49
"359",2014-12-25,47,42,5,0.3,4.88723404255319,0,616.3,5.69148936170213,3.98723404255319,24,2,6,15,47
"360",2014-12-26,31,29,2,0,4.33548387096774,0,423.6,6.64838709677419,2.02258064516129,6,4,10,11,31
"361",2014-12-27,50,45,5,0.078,6.862,0,556.9,9.58,4.144,19,1,9,21,50
"362",2014-12-28,48,33,15,0,2.79895833333333,0,729.65,5.68958333333333,-0.252083333333333,20,6,8,14,48
"363",2014-12-29,44,36,8,0,-1.4,0,853.6,1.30909090909091,-4.1,10,9,9,16,44
"364",2014-12-30,42,42,0,0,-4.68809523809524,0,952.9,-2.49285714285714,-6.88095238095238,8,13,4,17,42
"365",2014-12-31,49,41,8,0,-6.60816326530612,0,1205.8,-5.1265306122449,-8.00816326530612,7,4,23,15,49
"366",2015-01-01,186,175,11,0,-3.8005376344086,0,4054.9,-0.800537634408602,-6.78064516129032,11,9,22,14,56
"367",2015-01-02,46,38,8,0,-2.27391304347826,0,932.6,-0.395652173913043,-4.05217391304348,5,7,17,17,46
"368",2015-01-03,56,48,8,11.55,-0.4,0,1030.4,2.8125,-3.5125,15,11,19,11,56
"369",2015-01-04,62,57,5,9.76774193548387,0.2,0,1103.6,5.08709677419355,-4.7,19,12,8,23,62
"370",2015-01-05,47,39,8,0.182978723404255,-8.56595744680851,0,1248.6,-4.59148936170213,-12.4404255319149,10,13,17,7,47
"371",2015-01-06,38,22,16,0,-9.86052631578947,0,1058.7,-7.66052631578947,-12.0473684210526,7,6,13,12,38
"372",2015-01-07,35,30,5,0.274285714285714,-12.9571428571429,0,1083.5,-8.35714285714286,-17.5571428571429,9,6,11,9,35
"373",2015-01-08,42,30,12,0.566666666666667,-11.052380952381,0,1220.2,-7.50952380952381,-14.5142857142857,8,10,13,11,42
"374",2015-01-09,51,47,4,0.794117647058824,-8.64117647058823,0,1358.7,-5.04117647058824,-12.2411764705882,10,7,16,18,51
"375",2015-01-10,54,52,2,0,-11.75,0,1606.5,-8.87222222222222,-14.5333333333333,14,4,16,20,54
"376",2015-01-11,58,51,7,0.162068965517241,-4.22413793103448,0,1289,0.556896551724138,-8.92413793103448,21,3,13,21,58
"377",2015-01-12,50,38,12,1.644,-7.596,0,1279.8,0.2,-15.392,4,10,24,12,50
"378",2015-01-13,48,28,20,0.170833333333333,-14.8541666666667,0,1577,-10.2541666666667,-19.36875,6,8,17,17,48
"379",2015-01-14,47,36,11,0,-7.54042553191489,0,1200.4,-3.51489361702128,-11.4808510638298,7,9,12,19,47
"380",2015-01-15,40,29,11,0,-6.485,0,979.4,-2.08,-10.795,1,4,16,19,40
"381",2015-01-16,55,42,13,0,-6.18727272727273,0,1330.3,-3.41636363636364,-8.86909090909091,14,10,15,16,55
"382",2015-01-17,66,48,18,0,-6.45606060606061,0,1614.1,0.477272727272727,-11.5015151515152,32,4,14,16,66
"383",2015-01-18,59,47,12,1.07966101694915,3.05932203389831,0,881.5,5.42881355932203,0.679661016949152,30,4,8,17,59
"384",2015-01-19,41,39,2,0,-3.29268292682927,0,873,1.10731707317073,-7.69268292682927,3,8,17,13,41
"385",2015-01-20,38,30,8,0,-8.27631578947368,0,998.5,-4.78421052631579,-11.6763157894737,2,9,12,15,38
"386",2015-01-21,43,34,9,0,-6.62790697674419,0,1059,-2.66511627906977,-10.5837209302326,3,8,11,21,43
"387",2015-01-22,60,46,14,0,-3.26,0,1275.6,0.553333333333333,-6.97333333333333,10,17,19,14,60
"388",2015-01-23,54,42,12,0,-1.22407407407407,0,1038.1,1.22777777777778,-3.6,12,9,12,21,54
"389",2015-01-24,65,60,5,0,-1.48153846153846,0,1266.3,1.2,-4.16307692307692,21,3,14,27,65
"390",2015-01-25,63,48,15,0,-6.56507936507936,0,1547.6,-1.98253968253968,-11.1301587301587,20,15,18,10,63
"391",2015-01-26,41,34,7,0,-10.2,0,1156.2,-7.32195121951219,-13.0707317073171,4,9,13,15,41
"392",2015-01-27,40,31,9,0.35,-7.875,0,1035,-4.4875,-11.25,5,10,15,10,40
"393",2015-01-28,46,37,9,0,-6.3695652173913,0,1121,-0.821739130434783,-11.8347826086957,6,5,13,22,46
"394",2015-01-29,46,43,3,6.77391304347826,-1.37826086956522,0,891.4,1.12173913043478,-3.86739130434783,14,5,13,14,46
"395",2015-01-30,43,40,3,0.186046511627907,-7.27209302325581,0,1086.7,-0.779069767441861,-13.6651162790698,9,3,17,14,43
"396",2015-01-31,59,52,7,0,-7.96101694915254,0,1531.7,-1.87966101694915,-13.9525423728814,16,15,15,13,59
"397",2015-02-01,66,61,5,4.83333333333333,-7.75,0,1699.5,-1.68333333333333,-13.8166666666667,11,4,8,17,40
"398",2015-02-02,58,48,10,6.72413793103448,-12.648275862069,0,1777.6,-10.6689655172414,-14.6275862068966,15,5,22,16,58
"399",2015-02-03,47,40,7,0,-9.05106382978723,0,1271.4,-4.22127659574468,-13.8808510638298,7,12,17,11,47
"400",2015-02-04,45,36,9,1.36888888888889,-4.29777777777778,0,1003.4,-0.7,-7.89333333333333,3,12,14,16,45
"401",2015-02-05,58,49,9,0,-10.7689655172414,0,1668.6,-7.86896551724138,-13.6689655172414,8,7,23,20,58
"402",2015-02-06,55,50,5,0.598181818181818,-7.32727272727273,0,1393,-3.41454545454545,-11.2254545454545,11,8,22,14,55
"403",2015-02-07,40,33,7,4.08,-4.555,0,902.2,-1.7,-7.41,19,6,5,10,40
"404",2015-02-08,63,60,3,1.43015873015873,-9.55238095238095,0,1735.8,-6.73650793650794,-12.368253968254,13,10,24,16,63
"405",2015-02-09,49,46,3,0.306122448979592,-10.7795918367347,0,1410.2,-9.07959183673469,-12.3795918367347,5,3,22,19,49
"406",2015-02-10,37,32,5,0,-6.55675675675676,0,908.6,-3.81351351351351,-9.3,4,2,15,16,37
"407",2015-02-11,40,37,3,0.66,-3.2825,0,851.3,-1.265,-5.2175,4,5,15,16,40
"408",2015-02-12,49,44,5,0.16734693877551,-9.66734693877551,0,1355.7,-1.48367346938776,-17.7510204081633,4,8,24,13,49
"409",2015-02-13,37,32,5,0,-14.5243243243243,0,1203.4,-7.58108108108108,-21.4567567567568,5,9,8,15,37
"410",2015-02-14,59,55,4,0.352542372881356,-12.6169491525424,0,1806.4,-5.56949152542373,-19.664406779661,26,4,17,12,59
"411",2015-02-15,53,47,6,0.162264150943396,-22.1056603773585,0,2125.6,-19.0679245283019,-25.0622641509434,16,10,11,16,53
"412",2015-02-16,44,38,6,0,-17.4772727272727,0,1561,-12.5545454545455,-22.4,12,5,7,20,44
"413",2015-02-17,58,50,8,0,-10.4965517241379,0,1652.8,-7.54137931034483,-13.451724137931,7,10,28,13,58
"414",2015-02-18,54,44,10,0.25,-10.2166666666667,0,1523.7,-7.01666666666667,-13.3333333333333,7,12,24,11,54
"415",2015-02-19,38,32,6,0,-16.8684210526316,0,1325,-13.2684210526316,-20.4684210526316,7,4,16,11,38
"416",2015-02-20,39,35,4,0.174358974358974,-16.274358974359,0,1336.7,-11.274358974359,-21.274358974359,3,11,14,11,39
"417",2015-02-21,57,46,11,6.14736842105263,-8.93157894736842,0,1535.1,-6.49473684210526,-11.3526315789474,24,5,9,19,57
"418",2015-02-22,54,44,10,0.303703703703704,-9.1,0,1463.4,-2.77222222222222,-15.3518518518519,19,9,15,11,54
"419",2015-02-23,42,37,5,0,-17.1833333333333,0,1477.7,-14.2166666666667,-20.15,6,8,14,14,42
"420",2015-02-24,42,34,8,0.185714285714286,-12.8285714285714,0,1294.8,-7.34285714285714,-18.3142857142857,4,7,11,20,42
"421",2015-02-25,48,45,3,0,-10.3270833333333,0,1359.7,-7.08333333333333,-13.55625,9,12,10,17,48
"422",2015-02-26,47,42,5,0,-12.3936170212766,0,1428.5,-9.09361702127659,-15.5936170212766,8,12,12,15,47
"423",2015-02-27,64,47,17,0,-12.8140625,0,1972.1,-8.3125,-17.2296875,11,3,25,25,64
"424",2015-02-28,69,51,18,0,-9.5,0,1897.5,-4.48115942028986,-14.4985507246377,24,5,19,21,69
"425",2015-03-01,75,63,12,0,-5.78,0,1783.5,-3.1,-8.44,11,10,17,15,53
"426",2015-03-02,51,47,4,0,-4.66078431372549,0,1155.7,-1.37843137254902,-7.94313725490196,4,14,20,13,51
"427",2015-03-03,38,31,7,5.23684210526316,-4.17368421052632,0,842.6,1.31052631578947,-9.6578947368421,3,7,17,11,38
"428",2015-03-04,52,41,11,0.121153846153846,-4.30576923076923,0,1159.9,1.67692307692308,-10.1884615384615,4,14,18,16,52
"429",2015-03-05,53,37,16,0,-11.877358490566,0,1583.5,-8.95471698113207,-14.788679245283,9,7,24,13,53
"430",2015-03-06,49,41,8,0,-9.74285714285714,0,1359.4,-4.48775510204082,-14.8979591836735,10,12,16,11,49
"431",2015-03-07,49,37,12,0,-2.96734693877551,0,1027.4,-0.36530612244898,-5.48571428571429,20,4,11,14,49
"432",2015-03-08,54,48,6,0,0.062962962962963,0,968.6,3.18888888888889,-3.04444444444444,14,9,14,17,54
"433",2015-03-09,43,29,14,0,2.76279069767442,0,655.2,6.45348837209302,-0.941860465116279,5,6,15,17,43
"434",2015-03-10,40,39,1,0,2.3675,0,625.3,5.22,-0.57,4,8,16,12,40
"435",2015-03-11,54,41,13,0.0648148148148148,5.33518518518519,0,683.9,8.74814814814815,1.83518518518519,8,7,23,16,54
"436",2015-03-12,43,32,11,0,1.35348837209302,0,715.8,3.73953488372093,-1.03720930232558,7,16,13,7,43
"437",2015-03-13,43,36,7,0,2.07441860465116,0,684.8,4.24651162790698,-0.104651162790698,7,5,20,11,43
"438",2015-03-14,75,62,13,0.56,4.156,0,1038.3,6.016,2.284,22,13,21,19,75
"439",2015-03-15,54,40,14,0,3.9,0,761.4,6.8037037037037,0.996296296296296,17,5,11,21,54
"440",2015-03-16,52,38,14,1.86923076923077,5.13269230769231,0,669.1,9.42884615384615,0.830769230769231,3,7,18,24,52
"441",2015-03-17,40,36,4,0.455,1.455,0,661.8,6.31,-3.4,8,8,11,13,40
"442",2015-03-18,45,41,4,0,-0.84,0,847.8,3.2,-4.88,11,6,10,18,45
"443",2015-03-19,57,45,12,0,-2.04210526315789,0,1142.4,1.40526315789474,-5.4,15,6,11,25,57
"444",2015-03-20,53,47,6,0,3.48679245283019,0,769.2,7.47358490566038,-0.592452830188679,7,6,19,21,53
"445",2015-03-21,65,56,9,3.71230769230769,0.749230769230769,0,1121.3,6.58615384615385,-5.18769230769231,19,14,8,24,65
"446",2015-03-22,66,57,9,0,-5.29393939393939,0,1537.4,-1.23636363636364,-9.27272727272727,11,4,13,14,42
"447",2015-03-23,53,47,6,0,-6.75660377358491,0,1312.1,-2.86981132075472,-10.5528301886792,9,8,17,19,53
"448",2015-03-24,38,35,3,0,-3.40263157894737,0,813.3,1.28684210526316,-7.9921052631579,4,7,17,10,38
"449",2015-03-25,35,27,8,2.71142857142857,2.42,0,545.3,6.07714285714286,-1.23714285714286,5,7,12,11,35
"450",2015-03-26,48,36,12,1.41666666666667,3.33333333333333,0,704,5.61666666666667,1.05,13,7,21,7,48
"451",2015-03-27,40,30,10,0,-2.5075,0,820.3,2.07,-7.0775,4,4,17,15,40
"452",2015-03-28,39,36,3,0,-5.27692307692308,0,907.8,-0.523076923076923,-9.95384615384615,18,9,8,4,39
"453",2015-03-29,51,49,2,0,-0.905882352941176,0,964.2,4.55882352941176,-6.28823529411765,14,11,14,12,51
"454",2015-03-30,40,34,6,0,4.17,0,553.2,8.3625,-0.03,11,5,14,10,40
"455",2015-03-31,64,56,8,0,1.7921875,0,1037.3,4.56875,-0.9921875,15,5,26,18,64
"456",2015-04-01,62,53,9,0,2.32258064516129,0,972,6.22258064516129,-1.57741935483871,16,10,14,22,62
"457",2015-04-02,61,48,13,2.91967213114754,8.10163934426229,0,603.8,13.6426229508197,2.4655737704918,8,9,29,15,61
"458",2015-04-03,49,45,4,2.58571428571429,7.82857142857143,0,498.4,12.9857142857143,2.58571428571429,14,5,11,19,49
"459",2015-04-04,55,50,5,1.14909090909091,3.27454545454545,0,809.9,6.67454545454545,-0.225454545454545,20,5,15,15,55
"460",2015-04-05,71,56,15,0.171830985915493,0.543661971830986,0,1239.4,2.00140845070423,-0.914084507042254,18,7,13,33,71
"461",2015-04-06,47,36,11,0,5.05106382978723,0,608.6,8.31063829787234,1.24468085106383,8,4,22,13,47
"462",2015-04-07,39,32,7,0,4.76410256410256,0,516.2,7.14358974358974,2.38461538461538,4,10,12,13,39
"463",2015-04-08,58,55,3,14.7896551724138,2.86896551724138,0,877.6,4.24827586206897,1.48965517241379,5,9,27,17,58
"464",2015-04-09,45,39,6,10.0955555555556,6.34,0,524.7,10.38,2.2,5,16,16,8,45
"465",2015-04-10,49,43,6,1.85714285714286,10.7714285714286,0,354.2,16.7571428571429,4.78571428571429,4,15,13,17,49
"466",2015-04-11,67,62,5,0,7.46417910447761,0,705.9,11.6805970149254,3.14776119402985,16,6,23,22,67
"467",2015-04-12,78,64,14,0,9.99230769230769,0,624.6,16.9076923076923,3.07692307692308,27,14,17,20,78
"468",2015-04-13,42,33,9,3.25,13.3,0,197.4,19.5285714285714,7.05,3,12,13,14,42
"469",2015-04-14,62,55,7,0,11.5822580645161,0,397.9,17.3790322580645,5.77741935483871,6,11,24,21,62
"470",2015-04-15,57,48,9,0,10.4052631578947,0,432.9,14.5578947368421,6.15263157894737,5,13,24,15,57
"471",2015-04-16,42,35,7,0.707142857142857,9.60714285714286,0,352.5,13.8857142857143,5.23571428571429,6,7,16,13,42
"472",2015-04-17,69,52,17,0.101449275362319,14.2913043478261,0,255.9,20.3927536231884,8.16956521739131,15,3,16,35,69
"473",2015-04-18,77,64,13,0,14.5623376623377,0,264.7,20.5012987012987,8.62337662337662,18,6,15,19,58
"474",2015-04-19,64,57,7,8.3125,8.23125,0,625.2,11.9328125,4.515625,24,8,14,18,64
"475",2015-04-20,58,45,13,25.5241379310345,9.91034482758621,0,469.2,15.0413793103448,4.67931034482759,11,9,24,14,58
"476",2015-04-21,52,45,7,5.175,7.625,0,539.5,10.975,4.25,10,10,14,18,52
"477",2015-04-22,42,36,6,0.235714285714286,5.09285714285714,0,542.1,8.98571428571429,1.1,2,9,18,13,42
"478",2015-04-23,48,39,9,0,1.78958333333333,0,778.1,3.58958333333333,-0.0208333333333333,13,6,8,21,48
"479",2015-04-24,57,43,14,0,3.7,0,815.1,8.35789473684211,-0.971929824561404,14,4,16,23,57
"480",2015-04-25,68,52,16,0,4.99411764705882,0,884.4,9.92205882352941,-0.0205882352941177,31,5,14,18,68
"481",2015-04-26,50,46,4,0,8.444,0,477.8,13.03,3.772,22,6,15,7,50
"482",2015-04-27,58,51,7,0,9.34137931034483,0,502.2,13.3275862068966,5.34137931034483,5,7,24,22,58
"483",2015-04-28,57,42,15,0,12.5105263157895,0,312.9,19.0105263157895,5.91052631578947,13,7,22,15,57
"484",2015-04-29,71,61,10,0,13.043661971831,0,351.9,18.6253521126761,7.36197183098592,12,15,28,16,71
"485",2015-04-30,60,48,12,0,11.5933333333333,0,384.4,15.2666666666667,7.82,17,5,19,19,60
"486",2015-05-01,84,70,14,0,15.5333333333333,0,207.2,20.8142857142857,10.2428571428571,18,9,22,22,71
"487",2015-05-02,72,60,12,0,15.2388888888889,0,198.8,21.1333333333333,9.32083333333333,31,9,13,19,72
"488",2015-05-03,73,67,6,0,17.7013698630137,0,21.8,24.3931506849315,10.9164383561644,22,11,21,19,73
"489",2015-05-04,70,60,10,0.321428571428571,17.0928571428571,0,63.5,21.4314285714286,12.6585714285714,17,14,17,22,70
"490",2015-05-05,49,47,2,0,13.1979591836735,0,235.3,16.134693877551,10.2612244897959,5,9,18,17,49
"491",2015-05-06,42,31,11,0,15.5880952380952,0,101.3,21.0571428571429,9.87619047619048,7,13,14,8,42
"492",2015-05-07,76,59,17,0,16.8539473684211,0,87.1,22.271052631579,11.425,15,14,26,21,76
"493",2015-05-08,53,40,13,0,18.0811320754717,0.913207547169811,44.1,23.7622641509434,12.3830188679245,6,9,15,23,53
"494",2015-05-09,68,59,9,0.0264705882352941,20.25,2.46176470588235,14.4,26.5205882352941,13.8794117647059,24,8,13,23,68
"495",2015-05-10,77,73,4,1.89350649350649,18.8168831168831,1.68311688311688,66.7,23.5779220779221,13.6376623376623,27,15,21,14,77
"496",2015-05-11,45,40,5,4.4,15.0666666666667,0,132,17.9222222222222,12.2,9,6,18,12,45
"497",2015-05-12,67,54,13,0,12.4776119402985,0,370,17.055223880597,7.80746268656716,14,14,22,17,67
"498",2015-05-13,41,33,8,0,10.5146341463415,0,306.9,14.2439024390244,6.69268292682927,4,3,19,15,41
"499",2015-05-14,58,41,17,0,11.3672413793103,0,384.7,17.398275862069,5.23620689655172,6,6,25,21,58
"500",2015-05-15,56,48,8,0.0357142857142857,11.95,0,338.8,13.9428571428571,9.95714285714286,7,9,20,20,56
"501",2015-05-16,84,67,17,0,18.547619047619,0.814285714285714,22.4,25.6238095238095,11.4714285714286,28,9,18,29,84
"502",2015-05-17,43,36,7,0,16.9441860465116,0,45.4,20.9302325581395,12.8581395348837,16,4,10,13,43
"503",2015-05-18,47,39,8,0,19.5297872340426,2.12553191489362,28,25.1255319148936,13.8340425531915,14,6,12,15,47
"504",2015-05-19,51,39,12,0,12.0823529411765,0,301.8,19.2470588235294,4.91176470588235,12,7,18,14,51
"505",2015-05-20,71,49,22,0,9.94366197183099,0,572,15.7591549295775,4.11408450704225,12,10,33,16,71
"506",2015-05-21,64,55,9,0,13.975,0,257.6,18.9765625,8.89375,10,16,22,16,64
"507",2015-05-22,71,60,11,0,10.9098591549296,0,503.4,16.2619718309859,5.46760563380282,19,9,24,19,71
"508",2015-05-23,59,55,4,0,11.2898305084746,0,395.9,18.471186440678,4.10847457627119,17,7,17,18,59
"509",2015-05-24,65,58,7,0,17.5261538461538,0,30.8,25.0276923076923,9.94153846153846,19,8,13,25,65
"510",2015-05-25,73,57,16,0,20.4794520547945,2.56986301369863,6.6,24.7219178082192,16.1369863013699,18,13,30,12,73
"511",2015-05-26,53,44,9,0,22.2283018867925,4.24528301886792,0.9,26.7452830188679,17.611320754717,11,7,22,13,53
"512",2015-05-27,74,66,8,0,20.0554054054054,2.37162162162162,23.4,24.5972972972973,15.4135135135135,8,10,33,23,74
"513",2015-05-28,55,45,10,0,20.6763636363636,2.67636363636364,0,25.6981818181818,15.5618181818182,13,10,21,11,55
"514",2015-05-29,84,67,17,0,19.5083333333333,1.74166666666667,19.6,23.225,15.7916666666667,18,18,25,23,84
"515",2015-05-30,64,57,7,18.984375,19.640625,1.6875,3,27.46875,11.728125,19,7,22,16,64
"516",2015-05-31,60,56,4,20.4566666666667,9.83,0,490.2,12.03,7.53,27,8,11,14,60
"517",2015-06-01,78,69,9,0,12.2371794871795,0,449.5,14.8653846153846,9.50897435897436,25,11,29,13,78
"518",2015-06-02,51,36,15,0,13.9823529411765,0,204.9,17.9588235294118,9.90588235294118,12,5,21,13,51
"519",2015-06-03,63,49,14,0,13.9349206349206,0,256.1,17.5825396825397,10.2746031746032,3,7,28,25,63
"520",2015-06-04,50,39,11,0,16.504,0,74.8,21.232,11.692,6,8,12,24,50
"521",2015-06-05,51,43,8,18.556862745098,18.2882352941176,0.784313725490196,25.3,23.8529411764706,12.7019607843137,7,6,15,23,51
"522",2015-06-06,66,56,10,0,13.5954545454545,0,290.7,16.5318181818182,10.6363636363636,15,3,30,18,66
"523",2015-06-07,58,48,10,3.60344827586207,14.4586206896552,0,205.4,18.9120689655172,9.98620689655172,12,12,15,19,58
"524",2015-06-08,68,61,7,31.3411764705882,19.3823529411765,1.50588235294118,8.4,22.6058823529412,16.1529411764706,11,9,17,31,68
"525",2015-06-09,71,56,15,0.552112676056338,18.9366197183099,0.957746478873239,1.5,22.8859154929577,14.8661971830986,14,9,25,23,71
"526",2015-06-10,77,67,10,21.1090909090909,19.5649350649351,1.72077922077922,12,26.2467532467532,12.7831168831169,21,17,20,19,77
"527",2015-06-11,61,52,9,0,18.355737704918,0.467213114754098,6.8,23.4967213114754,13.2147540983607,14,8,17,22,61
"528",2015-06-12,67,55,12,5.70298507462687,16.7462686567164,0,84,18.6358208955224,14.7567164179104,15,7,17,28,67
"529",2015-06-13,63,57,6,0,18.7809523809524,0.780952380952381,0,22.2650793650794,15.1968253968254,29,9,10,15,63
"530",2015-06-14,73,61,12,3.07123287671233,17.158904109589,0,61.4,18.8643835616438,15.3534246575342,30,8,19,16,73
"531",2015-06-15,41,36,5,0,20.0365853658537,2.07560975609756,1.6,24.4292682926829,15.6439024390244,7,8,14,12,41
"532",2015-06-16,41,35,6,22.3048780487805,22.1365853658537,4.13658536585366,0,27.2219512195122,17.0292682926829,5,4,19,13,41
"533",2015-06-17,50,44,6,0,18.172,0.252,4,20.628,15.7,10,8,15,17,50
"534",2015-06-18,63,57,6,0,20.4952380952381,2.4952380952381,0,26.4952380952381,14.3952380952381,8,15,23,17,63
"535",2015-06-19,60,45,15,0,17.44,0,33.6,19.785,15.08,19,3,10,28,60
"536",2015-06-20,69,59,10,0,17.236231884058,0,52.7,21.431884057971,13.0405797101449,24,11,14,20,69
"537",2015-06-21,66,53,13,0,22.5515151515152,4.55151515151515,0,28.4939393939394,16.5090909090909,30,6,12,18,66
"538",2015-06-22,55,47,8,20.4727272727273,21.6545454545455,3.65454545454545,0,26.1090909090909,17.1,4,10,18,23,55
"539",2015-06-23,60,54,6,1.40666666666667,21.5866666666667,3.58666666666667,0,26.6733333333333,16.5,15,11,19,15,60
"540",2015-06-24,51,50,1,0,19.2705882352941,1.27058823529412,0,24.3196078431373,14.221568627451,12,9,17,13,51
"541",2015-06-25,56,45,11,0,19.9625,1.9625,0,22.75,17.175,12,7,23,14,56
"542",2015-06-26,63,47,16,0,19.1142857142857,1.11428571428571,0,22.5428571428571,15.6857142857143,13,10,20,20,63
"543",2015-06-27,79,72,7,33.6632911392405,16.2569620253165,0,137.7,19.6949367088608,12.8189873417722,26,14,18,21,79
"544",2015-06-28,54,48,6,15.3518518518519,13.9518518518519,0,218.6,15.5518518518519,12.2518518518519,18,5,14,17,54
"545",2015-06-29,53,49,4,0,19.2603773584906,1.26037735849057,0,24.1433962264151,14.277358490566,12,8,14,19,53
"546",2015-06-30,67,48,19,0,17.3388059701493,0,44.3,19.2059701492537,15.3850746268657,9,15,14,29,67
"547",2015-07-01,99,79,20,0,19.4040404040404,1.4040404040404,0,24.0808080808081,14.6272727272727,11,17,21,26,75
"548",2015-07-02,60,49,11,0,17.57,0,25.8,20.97,14.07,9,7,13,31,60
"549",2015-07-03,60,48,12,0,17.075,0,55.5,22.625,11.5,7,6,22,25,60
"550",2015-07-04,55,47,8,0,18.58,0.623636363636364,2.4,23.8145454545455,13.2454545454545,15,4,16,20,55
"551",2015-07-05,64,61,3,0,20.9421875,2.9421875,0,26.04375,15.8171875,26,8,13,17,64
"552",2015-07-06,59,51,8,0,21.8101694915254,3.81016949152542,0,25.9576271186441,17.5627118644068,16,9,14,20,59
"553",2015-07-07,66,56,10,10.3212121212121,22.3181818181818,4.31818181818182,0,27.7121212121212,16.9242424242424,9,12,20,25,66
"554",2015-07-08,54,47,7,0,17.8851851851852,0,6.2,21.0555555555556,14.7148148148148,9,8,18,19,54
"555",2015-07-09,53,44,9,0,18.9867924528302,1.01698113207547,1.6,22.311320754717,15.6547169811321,12,8,12,21,53
"556",2015-07-10,53,45,8,0,19.5679245283019,1.56792452830189,0,25.4037735849057,13.7320754716981,12,9,14,18,53
"557",2015-07-11,61,52,9,0,22.2918032786885,4.29180327868852,0,27.8016393442623,16.7639344262295,23,2,20,16,61
"558",2015-07-12,76,61,15,0,23.521052631579,5.52105263157895,0,27.9894736842105,18.9605263157895,24,10,19,23,76
"559",2015-07-13,50,42,8,0,23.336,5.336,0,27.484,19.188,12,5,13,20,50
"560",2015-07-14,62,53,9,1.1758064516129,20.6854838709677,2.68548387096774,0,25.1548387096774,16.1161290322581,17,11,13,21,62
"561",2015-07-15,53,41,12,0.173584905660377,17.2811320754717,0,38.1,21.7830188679245,12.6792452830189,7,10,17,19,53
"562",2015-07-16,51,40,11,0,18.6607843137255,0.66078431372549,0,22.4529411764706,14.8686274509804,13,4,23,11,51
"563",2015-07-17,73,64,9,5.54794520547945,18.8671232876712,0.867123287671233,0,20.6178082191781,17.1164383561644,16,8,20,29,73
"564",2015-07-18,85,75,10,0.0352941176470588,24.1705882352941,6.17058823529412,0,28.9588235294118,19.2823529411765,32,9,12,32,85
"565",2015-07-19,89,81,8,0.107865168539326,25.2112359550562,7.21123595505618,0,30.0168539325843,20.3191011235955,11,12,17,24,64
"566",2015-07-20,64,56,8,0,23.1171875,5.1171875,0,28.00625,18.128125,17,8,21,18,64
"567",2015-07-21,67,54,13,0,22.810447761194,4.81044776119403,0,26.6791044776119,18.8417910447761,14,6,18,29,67
"568",2015-07-22,36,26,10,0,20.4666666666667,2.46666666666667,0,25.7055555555556,15.2277777777778,8,6,6,16,36
"569",2015-07-23,36,31,5,0,20.4666666666667,2.46666666666667,0,26.625,14.2277777777778,5,9,11,11,36
"570",2015-07-24,86,80,6,0,21.3058139534884,3.30581395348837,0,27.8593023255814,14.7418604651163,18,10,25,33,86
"571",2015-07-25,72,62,10,0,24.3486111111111,6.34861111111111,0,28.4944444444444,20.2027777777778,21,6,17,28,72
"572",2015-07-26,63,55,8,0,24.0507936507937,6.05079365079365,0,29.2190476190476,18.8666666666667,22,7,11,23,63
"573",2015-07-27,58,50,8,0,25.5724137931035,7.57241379310345,0,31.1724137931034,19.9724137931034,11,14,13,20,58
"574",2015-07-28,49,37,12,0,25.8979591836735,7.89795918367347,0,31.4183673469388,20.3775510204082,11,7,18,13,49
"575",2015-07-29,55,48,7,0,26.8709090909091,8.87090909090909,0,31.8727272727273,21.7690909090909,10,5,13,27,55
"576",2015-07-30,41,36,5,0,25.609756097561,7.60975609756098,0,30.6536585365854,20.5658536585366,5,6,19,11,41
"577",2015-07-31,65,57,8,0.107692307692308,23.9107692307692,5.91076923076923,0,30.4261538461538,17.2953846153846,12,14,16,23,65
"578",2015-08-01,84,76,8,0,22.5166666666667,4.51666666666667,0,27.45,17.4916666666667,30,10,21,23,84
"579",2015-08-02,74,57,17,3.30810810810811,21.6513513513514,3.65135135135135,0,27.1027027027027,16.1243243243243,23,6,20,25,74
"580",2015-08-03,57,44,13,1.35964912280702,21.0333333333333,3.03333333333333,0,27.0614035087719,14.9052631578947,12,3,10,32,57
"581",2015-08-04,63,43,20,3.15238095238095,20.9666666666667,2.98571428571429,1.2,25.6714285714286,16.1619047619048,9,9,13,21,52
"582",2015-08-05,54,45,9,0,19.3074074074074,1.30740740740741,0,23.7851851851852,14.8296296296296,14,5,17,18,54
"583",2015-08-06,59,48,11,0,18.5033898305085,0.705084745762712,11.9,23.3983050847458,13.5084745762712,8,10,19,22,59
"584",2015-08-07,60,42,18,0,20.0166666666667,2.08333333333333,4,23.6833333333333,16.2666666666667,14,6,12,28,60
"585",2015-08-08,67,61,6,0,20.0328358208955,2.03283582089552,0,22.9731343283582,17.0925373134328,19,10,21,17,67
"586",2015-08-09,60,53,7,0,19.6,1.6,0,24.1,15.08,25,4,16,15,60
"587",2015-08-10,43,39,4,13.9325581395349,19.7255813953488,1.72558139534884,0,22.8209302325581,16.6255813953488,13,11,8,11,43
"588",2015-08-11,46,41,5,0.956521739130435,22.1173913043478,4.11739130434783,0,26.2130434782609,17.9260869565217,7,8,18,13,46
"589",2015-08-12,50,37,13,0,19.684,1.684,0,23.56,15.708,6,10,14,20,50
"590",2015-08-13,43,36,7,0,19.2,1.2,0,25.0837209302326,13.3162790697674,5,4,13,21,43
"591",2015-08-14,59,46,13,3.58813559322034,22.0796610169492,4.07966101694915,0,24.4254237288136,19.7118644067797,16,5,16,22,59
"592",2015-08-15,76,66,10,0,23.6842105263158,5.68421052631579,0,27.6855263157895,19.6828947368421,19,5,23,29,76
"593",2015-08-16,81,73,8,0,24.7234567901235,6.72345679012346,0,29.8962962962963,19.5506172839506,27,7,23,24,81
"594",2015-08-17,64,51,13,0,25.9875,7.9875,0,31.178125,20.696875,14,9,15,26,64
"595",2015-08-18,42,33,9,0.466666666666667,23.547619047619,5.54761904761905,0,26.2904761904762,20.8047619047619,14,7,9,12,42
"596",2015-08-19,62,48,14,2.74838709677419,25.2290322580645,7.22903225806452,0,29.0032258064516,21.3612903225806,10,11,9,32,62
"597",2015-08-20,46,39,7,5.4695652173913,22.3304347826087,4.3304347826087,0,25.7260869565217,18.9347826086957,6,10,10,20,46
"598",2015-08-21,55,43,12,0,19.2,1.2,0,23.0363636363636,15.2818181818182,16,6,5,28,55
"599",2015-08-22,77,61,16,0,18.7818181818182,0.781818181818182,0,23.5974025974026,13.9493506493506,27,4,30,16,77
"600",2015-08-23,66,54,12,0,20.0181818181818,2.01818181818182,0,24.0590909090909,15.9,31,9,15,11,66
"601",2015-08-24,46,40,6,1.06521739130435,20.3,2.3,0,23.7739130434783,16.8260869565217,7,7,11,21,46
"602",2015-08-25,41,35,6,0,18.1365853658537,0.136585365853659,0,20.5731707317073,15.7,9,8,14,10,41
"603",2015-08-26,47,37,10,0,17.9170212765957,0.119148936170213,9.5,20.4170212765957,15.3170212765957,17,8,15,7,47
"604",2015-08-27,63,45,18,0,17.1492063492063,0,53.6,20.0936507936508,14.1111111111111,14,7,21,21,63
"605",2015-08-28,52,44,8,0,17.9692307692308,0.169230769230769,10.4,23.2153846153846,12.6384615384615,10,10,12,20,52
"606",2015-08-29,59,53,6,0,20.264406779661,2.26440677966102,0,24.9237288135593,15.5050847457627,15,10,12,22,59
"607",2015-08-30,65,53,12,0,22.54,4.54,0,25.74,19.24,25,10,15,15,65
"608",2015-08-31,75,69,6,0,24.224,6.224,0,29.496,18.852,17,11,25,22,75
"609",2015-09-01,95,88,7,0,23.4347368421053,5.43473684210526,0,28.1873684210526,18.5821052631579,25,14,34,22,95
"610",2015-09-02,52,43,9,1.21153846153846,25.7846153846154,7.78461538461538,0,31.2846153846154,20.1980769230769,7,10,14,21,52
"611",2015-09-03,58,44,14,0,25.9379310344828,7.93793103448276,0,29.051724137931,22.7241379310345,9,7,27,15,58
"612",2015-09-04,66,58,8,0,24.2,6.2,0,26.7636363636364,21.5454545454545,20,12,21,13,66
"613",2015-09-05,68,61,7,0,24.5985294117647,6.59852941176471,0,29.0779411764706,20.1191176470588,21,5,26,16,68
"614",2015-09-06,65,58,7,0,25.46,7.46,0,29.6769230769231,21.1692307692308,27,7,14,17,65
"615",2015-09-07,50,44,6,0.672,26.848,8.848,0,32.096,21.516,12,5,14,19,50
"616",2015-09-08,63,54,9,6.9968253968254,25.7730158730159,7.77301587301587,0,29.0301587301587,22.5,11,11,20,21,63
"617",2015-09-09,48,40,8,7.2125,21.15625,3.15625,0,25.1,17.2125,7,5,15,21,48
"618",2015-09-10,58,44,14,0,18.948275862069,0.948275862068966,0,23.4275862068966,14.4568965517241,8,8,21,21,58
"619",2015-09-11,63,54,9,4.02222222222222,18.4555555555556,0.455555555555556,0,23.5555555555556,13.2666666666667,9,11,18,25,63
"620",2015-09-12,46,36,10,16.8608695652174,13.9782608695652,0,185,16.3869565217391,11.5565217391304,8,3,20,15,46
"621",2015-09-13,76,70,6,2.70526315789474,13.2473684210526,0,361.2,15.7210526315789,10.6736842105263,24,7,24,21,76
"622",2015-09-14,51,45,6,0,16.6392156862745,0,69.4,23.7039215686275,9.47450980392157,9,11,13,18,51
"623",2015-09-15,63,49,14,0,20.1777777777778,2.17777777777778,0,26.5888888888889,13.6666666666667,9,12,22,20,63
"624",2015-09-16,64,54,10,0,22.025,4.025,0,27.5125,16.45625,8,15,18,23,64
"625",2015-09-17,53,44,9,0,21.8603773584906,3.86037735849057,0,27.0924528301887,16.5509433962264,14,8,9,22,53
"626",2015-09-18,66,43,23,0,21.5636363636364,3.56363636363636,0,26.0272727272727,17.0818181818182,6,7,23,30,66
"627",2015-09-19,70,56,14,5.44285714285714,18.6,0.6,0,24.0457142857143,13.1371428571429,29,9,11,21,70
"628",2015-09-20,88,75,13,0,14.2545454545455,0,329.6,18,10.5090909090909,31,7,31,19,88
"629",2015-09-21,35,31,4,0,16.5057142857143,0,52.3,20.4885714285714,12.4314285714286,7,2,14,12,35
"630",2015-09-22,53,43,10,0,17.1056603773585,0,47.4,22.0603773584906,12.1320754716981,10,15,12,16,53
"631",2015-09-23,70,64,6,0,18.7057142857143,0.797142857142857,6.4,23.7371428571429,13.6742857142857,4,9,25,32,70
"632",2015-09-24,64,51,13,0,19.0875,1.1375,3.2,21.8625,16.2125,13,14,20,17,64
"633",2015-09-25,59,43,16,0,17.5813559322034,0,24.7,20.3677966101695,14.7186440677966,14,6,17,22,59
"634",2015-09-26,66,58,8,0,15.7484848484848,0,148.6,18.9545454545455,12.4424242424242,19,9,14,24,66
"635",2015-09-27,65,51,14,0,18.0923076923077,0.156923076923077,4.2,21.1630769230769,15.0215384615385,25,6,11,23,65
"636",2015-09-28,55,49,6,2.64181818181818,19.7709090909091,1.77090909090909,0,21.4418181818182,18.1,9,12,13,21,55
"637",2015-09-29,51,48,3,9.41176470588235,17.6078431372549,0,20,21.1921568627451,13.9450980392157,10,8,12,21,51
"638",2015-09-30,54,49,5,0,13.9148148148148,0,220.6,18.7703703703704,9.05925925925926,12,5,25,12,54
"639",2015-10-01,84,68,16,0,10.5714285714286,0,624,15.1285714285714,5.92857142857143,17,9,24,17,67
"640",2015-10-02,44,34,10,0,9.19090909090909,0,387.6,12.3818181818182,5.9,11,6,13,14,44
"641",2015-10-03,55,50,5,0.06,10.26,0,425.7,12.58,7.84,11,13,13,18,55
"642",2015-10-04,80,72,8,0,12.4075,0,447.4,14.2,10.5225,11,11,15,19,56
"643",2015-10-05,65,52,13,0,13,0,325,14.7584615384615,11.2415384615385,15,11,23,16,65
"644",2015-10-06,58,47,11,0,14.251724137931,0,217.4,16.9051724137931,11.5931034482759,8,12,18,20,58
"645",2015-10-07,49,44,5,0,15.9510204081633,0,100.4,21.069387755102,10.7428571428571,9,12,11,17,49
"646",2015-10-08,55,48,7,7.14,11.7654545454545,0,342.9,14.1163636363636,9.41454545454546,6,12,17,20,55
"647",2015-10-09,58,51,7,0.591379310344828,12.2775862068966,0,331.9,16.8344827586207,7.62068965517241,13,9,17,19,58
"648",2015-10-10,84,72,12,0,10.7416666666667,0,609.7,14.6297619047619,6.75357142857143,27,10,23,24,84
"649",2015-10-11,75,70,5,0,16.9826666666667,0,76.3,21.984,11.952,27,7,17,24,75
"650",2015-10-12,39,39,0,8.01025641025641,18.6102564102564,0.61025641025641,0,22.2435897435897,14.8769230769231,10,1,11,17,39
"651",2015-10-13,49,33,16,0,14.9142857142857,0,151.2,17.9714285714286,11.8428571428571,7,7,24,11,49
"652",2015-10-14,62,48,14,0,10.1967741935484,0,483.8,13.0677419354839,7.3258064516129,6,13,17,26,62
"653",2015-10-15,39,33,6,2.23589743589744,12.5794871794872,0,211.4,18.1564102564103,6.98205128205128,7,8,16,8,39
"654",2015-10-16,83,76,7,0.23855421686747,8.1289156626506,0,819.3,13.3385542168675,2.81927710843373,14,9,18,19,60
"655",2015-10-17,61,57,4,0,3.89180327868852,0,860.6,7.02295081967213,0.660655737704918,18,10,9,24,61
"656",2015-10-18,49,33,16,0,3.50612244897959,0,710.2,6.81836734693877,0.193877551020408,15,4,17,13,49
"657",2015-10-19,52,42,10,0.565384615384615,7.92307692307692,0,524,15.5961538461538,0.238461538461538,9,8,20,15,52
"658",2015-10-20,56,43,13,0.185714285714286,14.9928571428571,0,168.4,17.6357142857143,12.3071428571429,8,11,16,21,56
"659",2015-10-21,51,42,9,1.8843137254902,11.3745098039216,0,337.9,14.0490196078431,8.6,11,5,21,14,51
"660",2015-10-22,55,47,8,0,11.3254545454545,0,367.1,16.3381818181818,6.22545454545455,9,11,12,23,55
"661",2015-10-23,54,37,17,0,5.43888888888889,0,678.3,8.66111111111111,2.2037037037037,4,7,30,13,54
"662",2015-10-24,51,44,7,11.3058823529412,11.3,0,341.7,14.8529411764706,7.73137254901961,18,8,12,13,51
"663",2015-10-25,61,52,9,0,9.72131147540984,0,505,13.9639344262295,5.37868852459016,21,6,16,18,61
"664",2015-10-26,46,42,4,0,7.8,0,469.2,10.3869565217391,5.2,9,2,22,13,46
"665",2015-10-27,58,52,6,0,8.51551724137931,0,550.1,11.3,5.64655172413793,7,19,17,15,58
"666",2015-10-28,41,36,5,57.6487804878049,12,0,246,14.7560975609756,9.14390243902439,5,6,14,16,41
"667",2015-10-29,58,52,6,0.405172413793103,9.21034482758621,0,509.8,12.7379310344828,5.68275862068965,13,11,14,20,58
"668",2015-10-30,82,62,20,0,6.43536585365854,0,948.3,9.79024390243903,2.98048780487805,19,8,18,19,64
"669",2015-10-31,93,63,30,0.917204301075269,6.84838709677419,0,1037.1,10.9795698924731,2.61720430107527,27,9,16,19,71
"670",2015-11-01,122,107,15,3.5,11.9114754098361,0,742.8,15.7229508196721,8,11,16,28,20,75
"671",2015-11-02,51,42,9,0,10.0588235294118,0,405,14.3941176470588,5.62352941176471,11,7,15,18,51
"672",2015-11-03,41,36,5,0,14.4975609756098,0,143.6,19.8780487804878,9.02195121951219,1,3,14,23,41
"673",2015-11-04,72,56,16,0,12.7972222222222,0,374.6,16.0027777777778,9.59166666666667,6,15,24,27,72
"674",2015-11-05,67,58,9,0,7.51641791044776,0,702.4,10.8701492537313,10.744776119403,4,15,27,21,67
"675",2015-11-06,77,59,18,2.61688311688312,13.0246753246753,0,383.1,17.5909090909091,8.32727272727273,23,12,27,15,77
"676",2015-11-07,63,54,9,0,8.43174603174603,0,602.8,12.347619047619,4.41587301587302,15,9,17,22,63
"677",2015-11-08,66,56,10,0,6.64545454545455,0,749.4,10.4,2.89090909090909,28,8,24,6,66
"678",2015-11-09,88,74,14,0,6.76363636363636,0,988.8,11.1636363636364,2.26363636363636,6,9,27,32,74
"679",2015-11-10,50,43,7,14.508,7.33,0,533.5,9.688,4.872,6,9,20,15,50
"680",2015-11-11,60,52,8,1.825,9.75833333333333,0,494.5,12.0916666666667,7.33333333333333,4,9,18,14,45
"681",2015-11-12,48,37,11,1.40416666666667,9.89791666666667,0,388.9,12.2875,7.50833333333333,8,10,12,18,48
"682",2015-11-13,62,56,6,0,6.31612903225806,0,724.4,10.2838709677419,2.34838709677419,17,9,18,18,62
"683",2015-11-14,64,53,11,0,4.15625,0,886,6.51875,1.69375,22,8,16,18,64
"684",2015-11-15,61,53,8,0,9.86065573770492,0,496.5,15.1213114754098,4.6,21,7,15,18,61
"685",2015-11-16,81,66,15,0,8.34444444444444,0,782.1,11.4444444444444,5.14444444444444,10,18,20,33,81
"686",2015-11-17,60,44,16,0,6.31,0,701.4,9.2,3.33,8,13,20,19,60
"687",2015-11-18,49,37,12,0.946938775510204,11.4265306122449,0,322.1,13.965306122449,8.88775510204082,9,11,16,13,49
"688",2015-11-19,49,41,8,0.5,10.7387755102041,0,355.8,15.9571428571429,5.42040816326531,7,8,16,18,49
"689",2015-11-20,66,55,11,0,7.01212121212121,0,725.2,10.2939393939394,3.34848484848485,7,11,23,25,66
"690",2015-11-21,59,52,7,0.355932203389831,6.9864406779661,0,649.8,10.1440677966102,3.18983050847458,21,6,11,21,59
"691",2015-11-22,58,51,7,0.186206896551724,1.12068965517241,0,979,5.13448275862069,-2.99310344827586,28,7,12,11,58
"692",2015-11-23,45,40,5,0.477777777777778,-0.711111111111111,0,842,2.58888888888889,-4.01111111111111,5,7,18,15,45
"693",2015-11-24,59,48,11,0.466101694915254,3.34745762711864,0,864.5,6.66101694915254,0.0271186440677966,8,15,19,17,59
"694",2015-11-25,44,35,9,0.195454545454545,4.77272727272727,0,582,8.97045454545455,0.477272727272727,6,3,18,17,44
"695",2015-11-26,63,50,13,0,10.3333333333333,0,483,13.4444444444444,7.22222222222222,8,9,21,25,63
"696",2015-11-27,69,45,24,2.02753623188406,7.60724637681159,0,717.1,13.5855072463768,1.62898550724638,25,8,9,27,69
"697",2015-11-28,49,40,9,0,0.675510204081633,0,848.9,2.3,-0.948979591836735,15,5,12,17,49
"698",2015-11-29,58,52,6,0,0.382758620689655,0,1021.8,3.78620689655172,-3.01724137931034,19,5,14,20,58
"699",2015-11-30,40,32,8,0,1.74,0,650.4,3.55,-0.17,7,6,17,10,40
"700",2015-12-01,91,81,10,1.70549450549451,5.68351648351648,0,1120.8,8.93956043956044,2.42747252747253,22,11,29,29,91
"701",2015-12-02,32,26,6,0,5.425,0,402.4,7.9125,2.9375,7,6,11,8,32
"702",2015-12-03,50,39,11,0,5.142,0,642.9,7.07,3.214,8,7,14,21,50
"703",2015-12-04,67,54,13,0,5.58358208955224,0,831.9,6.38358208955224,4.76716417910448,11,11,14,31,67
"704",2015-12-05,54,46,8,0,4.51111111111111,0,728.4,7.23333333333333,1.78888888888889,16,6,6,26,54
"705",2015-12-06,82,69,13,0,2.57926829268293,0,1264.5,4.97560975609756,0.0829268292682927,11,8,22,16,57
"706",2015-12-07,58,49,9,0,3.4551724137931,0,843.6,5.58793103448276,1.32241379310345,7,9,17,25,58
"707",2015-12-08,50,35,15,0,5.488,0,625.6,6.68,4.198,7,15,15,13,50
"708",2015-12-09,66,52,14,0.00909090909090909,8.68181818181818,0,615,11.4939393939394,5.86666666666667,12,5,19,30,66
"709",2015-12-10,50,44,6,0,7.938,0,503.1,10.848,5.01,9,12,19,10,50
"710",2015-12-11,55,45,10,0,9.62,0,460.9,13.6436363636364,5.59636363636364,10,9,15,21,55
"711",2015-12-12,86,72,14,0.362790697674419,6.66046511627907,0,975.2,9.24418604651163,4.06744186046512,28,6,16,19,69
"712",2015-12-13,52,43,9,0.0519230769230769,6.68269230769231,0,588.5,8.14807692307692,5.21730769230769,16,6,9,21,52
"713",2015-12-14,43,36,7,3.43488372093023,10.1209302325581,0,338.8,13.2720930232558,6.88604651162791,6,9,17,11,43
"714",2015-12-15,58,45,13,0,6.63793103448276,0,659,10.6568965517241,2.51896551724138,5,14,22,17,58
"715",2015-12-16,55,47,8,1.1,4.28363636363636,0,754.4,6.75090909090909,1.81636363636364,5,10,19,21,55
"716",2015-12-17,68,60,8,0.188235294117647,6.66470588235294,0,770.8,10.5176470588235,2.80588235294118,6,17,21,24,68
"717",2015-12-18,61,46,15,0,0.949180327868852,0,1040.1,3.47868852459016,-1.59016393442623,16,10,12,23,61
"718",2015-12-19,58,54,4,0,-1.23793103448276,0,1115.8,-0.137931034482759,-2.25862068965517,22,12,12,12,58
"719",2015-12-20,54,45,9,0,2.1,0,858.6,6.17777777777778,-2,14,17,11,12,54
"720",2015-12-21,41,33,8,3.61219512195122,6.76829268292683,0,460.5,8.18048780487805,5.33414634146341,12,5,9,15,41
"721",2015-12-22,58,45,13,1.41551724137931,9.77758620689655,0,476.9,12.9655172413793,6.48965517241379,12,9,18,19,58
"722",2015-12-23,67,53,14,0.164179104477612,5.77313432835821,0,819.2,8.14850746268657,2.82985074626866,24,10,10,23,67
"723",2015-12-24,64,51,13,0,10.3359375,0,490.5,14.225,6.346875,15,12,11,26,64
"724",2015-12-25,59,57,2,0,6.50677966101695,0,678.1,10.1457627118644,2.86101694915254,13,11,14,21,59
"725",2015-12-26,47,42,5,2.05106382978723,3.33191489361702,0,689.4,4.93404255319149,1.6468085106383,18,4,14,11,47
"726",2015-12-27,49,37,12,2.5,1.84897959183673,0,791.4,4.12448979591837,-0.526530612244898,11,3,11,24,49
"727",2015-12-28,63,55,8,12.0111111111111,-2.23809523809524,0,1275,0.942857142857143,-5.34603174603175,24,5,14,20,63
"728",2015-12-29,51,39,12,15.9352941176471,3.03921568627451,0,763,4.94705882352941,1.02941176470588,5,3,18,25,51
"729",2015-12-30,44,30,14,0.0409090909090909,3.21363636363636,0,650.6,4.7,1.62727272727273,9,7,13,15,44
"730",2015-12-31,56,49,7,0,1.2375,0,938.7,1.85,0.6125,13,8,13,22,56
"731",2016-01-01,149,140,9,0.61744966442953,-1.00872483221477,0,2832.3,0.768456375838926,-2.76308724832215,11,9,15,21,56
"732",2016-01-02,51,33,18,0.180392156862745,-0.650980392156863,0,951.2,1.56862745098039,-2.86078431372549,10,7,12,22,51
"733",2016-01-03,54,42,12,0.181481481481481,-3.87222222222222,0,1181.1,2.33703703703704,-10.0722222222222,18,8,15,13,54
"734",2016-01-04,32,27,5,0.46875,-12.034375,0,961.1,-9.878125,-14.1125,3,2,13,14,32
"735",2016-01-05,53,46,7,0.0924528301886793,-3.59433962264151,0,1144.5,0.911320754716981,-13.0924528301887,4,10,19,20,53
"736",2016-01-06,40,34,6,0.255,-0.995,0,759.8,2.49,-4.395,5,7,15,13,40
"737",2016-01-07,53,50,3,1.10943396226415,0.624528301886792,0,920.9,3.60943396226415,-2.44528301886792,6,7,16,24,53
"738",2016-01-08,59,53,6,0.664406779661017,-2.46101694915254,0,1207.2,1.55762711864407,-0.0389830508474576,9,10,23,17,59
"739",2016-01-09,54,46,8,2.8037037037037,5.65740740740741,0,666.5,7.87592592592593,3.35925925925926,19,6,20,9,54
"740",2016-01-10,55,49,6,18.7545454545455,-0.190909090909091,0,1000.5,5.72909090909091,-5.80909090909091,18,9,18,10,55
"741",2016-01-11,50,41,9,0.2,-7.1,0,1255,-5.3,-8.8,4,9,16,21,50
"742",2016-01-12,44,34,10,2.32727272727273,-4.41818181818182,0,986.4,-0.663636363636364,-8.14545454545454,2,11,15,16,44
"743",2016-01-13,36,33,3,0.430555555555556,-7.45833333333333,0,916.5,-6.08611111111111,-8.83055555555556,14,7,9,6,36
"744",2016-01-14,49,47,2,0.195918367346939,-4.19591836734694,0,1087.6,-0.9,-7.39183673469388,8,13,19,9,49
"745",2016-01-15,52,42,10,1.39615384615385,1.85769230769231,0,839.4,5.68076923076923,-1.96538461538462,14,4,20,14,52
"746",2016-01-16,65,54,11,1.12615384615385,0.655384615384615,0,1127.4,3.93692307692308,-2.62615384615385,26,15,14,10,65
"747",2016-01-17,83,69,14,0,-4.38072289156627,0,1857.6,0.33855421686747,-9.09036144578313,27,11,20,25,83
"748",2016-01-18,56,49,7,0.625,-8.38928571428571,0,1477.8,-6.57857142857143,-10.1,6,8,24,18,56
"749",2016-01-19,50,40,10,0.924,-7.968,0,1298.4,-2.616,-13.236,6,12,16,16,50
"750",2016-01-20,58,48,10,0,-4.50689655172414,0,1305.4,-2.7,-6.30689655172414,15,11,20,12,58
"751",2016-01-21,44,33,11,0.0863636363636364,-4.31363636363636,0,981.8,-2.07272727272727,-6.54090909090909,5,7,16,16,44
"752",2016-01-22,46,39,7,0.645652173913044,-4.27173913043478,0,1024.5,-1.82826086956522,-6.68695652173913,6,6,11,23,46
"753",2016-01-23,51,40,11,0.42156862745098,-5.97450980392157,0,1222.7,-2.39019607843137,-9.54313725490196,21,1,13,16,51
"754",2016-01-24,76,70,6,0,-3.88815789473684,0,1663.5,0.223684210526316,-8,27,11,17,21,76
"755",2016-01-25,72,61,11,0.0888888888888889,2.43333333333333,0,1120.8,5.04444444444444,-0.188888888888889,7,18,19,28,72
"756",2016-01-26,46,33,13,0.126086956521739,4.26086956521739,0,632,6.92173913043478,1.6,4,11,16,15,46
"757",2016-01-27,47,36,11,0.893617021276596,-0.168085106382979,0,853.9,1.72127659574468,-1.96808510638298,9,6,20,12,47
"758",2016-01-28,47,39,8,0.991489361702128,0.804255319148936,0,808.2,2.30425531914894,-0.791489361702128,11,5,19,12,47
"759",2016-01-29,41,35,6,0,-3.21219512195122,0,869.7,1.27560975609756,-7.6,11,9,12,9,41
"760",2016-01-30,57,53,4,0.0894736842105263,-0.231578947368421,0,1039.2,6.32631578947368,-6.77894736842105,13,5,12,27,57
"761",2016-01-31,57,51,6,0.408771929824561,6.20350877192983,0,672.4,9.74561403508772,2.64736842105263,18,11,18,10,57
"762",2016-02-01,83,73,10,0,5.88313253012048,0,1005.7,9.86626506024096,1.80843373493976,27,14,20,22,83
"763",2016-02-02,48,36,12,3.6875,1.7375,0,780.6,2.72083333333333,0.654166666666667,10,7,9,22,48
"764",2016-02-03,53,41,12,0.362264150943396,8.90188679245283,0,482.2,15.3735849056604,2.3377358490566,9,5,23,16,53
"765",2016-02-04,59,46,13,0.0508474576271186,2.1,0,938.1,4.47966101694915,-0.289830508474576,4,13,29,13,59
"766",2016-02-05,50,42,8,0,0.156,0,892.2,2.256,-1.958,6,5,14,25,50
"767",2016-02-06,60,48,12,0,2.34,0,939.6,4.64,0.0266666666666667,16,4,24,16,60
"768",2016-02-07,61,53,8,0,2.82622950819672,0,925.6,6,-0.434426229508197,13,8,23,17,61
"769",2016-02-08,52,35,17,0,1.59230769230769,0,853.2,4.49230769230769,-1.30769230769231,3,17,14,18,52
"770",2016-02-09,45,39,6,0.0266666666666667,0.117777777777778,0,804.7,2.20888888888889,-1.97333333333333,7,9,8,21,45
"771",2016-02-10,49,31,18,0,-5.3,0,1141.7,-0.0877551020408163,-10.4244897959184,6,5,23,15,49
"772",2016-02-11,53,44,9,0.620754716981132,-12.4981132075472,0,1616.4,-8.86415094339623,-16.1207547169811,5,11,18,19,53
"773",2016-02-12,52,44,8,0.188461538461538,-8.88269230769231,0,1397.9,-3.39423076923077,-14.3653846153846,10,6,15,21,52
"774",2016-02-13,68,55,13,0.242647058823529,-19.4235294117647,0,2544.8,-14.2235294117647,-24.6235294117647,21,6,17,24,68
"775",2016-02-14,41,35,6,0,-15.9414634146341,0,1391.6,-9.58536585365854,-22.2975609756098,15,9,10,7,41
"776",2016-02-15,59,46,13,0,-4.79322033898305,0,1344.8,0.00677966101694915,-9.59322033898305,12,9,11,27,59
"777",2016-02-16,54,41,13,0,-0.207407407407407,0,983.2,0.492592592592593,-0.807407407407407,4,11,17,22,54
"778",2016-02-17,36,30,6,0,-4.66111111111111,0,815.8,0,-9.22222222222222,6,6,19,5,36
"779",2016-02-18,67,58,9,0,-7.11940298507463,0,1683,-3.01194029850746,-11.2149253731343,10,16,14,27,67
"780",2016-02-19,78,67,11,1.04615384615385,2.31794871794872,0,1223.2,7.97692307692308,-3.34102564102564,15,9,18,19,61
"781",2016-02-20,82,68,14,0,8.69512195121951,0,763,12.7243902439024,4.56585365853658,28,8,18,28,82
"782",2016-02-21,56,49,7,0,3.24107142857143,0,826.5,7.42321428571429,-0.941071428571429,23,3,16,14,56
"783",2016-02-22,53,46,7,0,-1.44528301886792,0,1030.6,0.909433962264151,-3.78867924528302,9,9,14,21,53
"784",2016-02-23,44,40,4,0,-0.990909090909091,0,835.6,0.8,-2.68181818181818,1,12,22,9,44
"785",2016-02-24,44,32,12,5.54318181818182,1.26136363636364,0,736.5,2.80227272727273,-0.379545454545455,4,13,15,12,44
"786",2016-02-25,48,42,6,2.2875,-1.8625,0,953.4,2.1375,-5.8625,10,6,17,15,48
"787",2016-02-26,63,48,15,0,-6.18412698412698,0,1523.6,-2.31587301587302,-9.96031746031746,5,13,24,21,63
"788",2016-02-27,63,56,7,0,1.02539682539683,0,1069.4,5.84920634920635,-3.8984126984127,27,3,11,22,63
"789",2016-02-28,68,61,7,0,8.42941176470588,0,650.8,13.95,2.90882352941177,26,5,15,22,68
"790",2016-02-29,57,52,5,0.370175438596491,2.34561403508772,0,892.3,10.9771929824561,-6.2859649122807,4,11,23,19,57
"791",2016-03-01,62,58,4,0.17741935483871,-8.12096774193548,0,1619.5,-5.98709677419355,-10.2548387096774,13,15,21,13,62
"792",2016-03-02,51,46,5,0.164705882352941,-7.04705882352941,0,1277.4,-3.76470588235294,-10.2294117647059,4,13,15,19,51
"793",2016-03-03,64,51,13,0.165625,-6.0484375,0,1539.1,-2.9828125,-9.03125,13,5,25,21,64
"794",2016-03-04,53,48,5,0.290566037735849,-1.91509433962264,0,1055.5,0.779245283018868,-4.59433962264151,7,7,25,14,53
"795",2016-03-05,73,63,10,0.326027397260274,-1.28904109589041,0,1408.1,0.673972602739726,-3.15205479452055,30,4,12,27,73
"796",2016-03-06,61,48,13,0.180327868852459,-1.1,0,1165.1,2.28032786885246,-4.48032786885246,16,8,12,25,61
"797",2016-03-07,61,56,5,0.183606557377049,6.94426229508197,0,674.4,11.9885245901639,1.8,8,6,29,18,61
"798",2016-03-08,45,40,5,0.191111111111111,8.35777777777778,0,433.9,11.3911111111111,5.32,6,5,15,19,45
"799",2016-03-09,69,53,16,0.165217391304348,11.8130434782609,0,426.9,17.4521739130435,6.09130434782609,14,8,26,21,69
"800",2016-03-10,59,51,8,4.94406779661017,9.23898305084746,0,516.9,15.0576271186441,3.42033898305085,6,17,23,13,59
"801",2016-03-11,54,46,8,0,5.5,0,675,8.6,2.4,4,9,21,20,54
"802",2016-03-12,64,57,7,0.175,8.225,0,625.6,15.8875,0.5625,18,8,16,22,64
"803",2016-03-13,64,59,5,0.15,6.35,0,745.6,9.05,3.625,26,7,11,20,64
"804",2016-03-14,62,50,12,2.69677419354839,6.44838709677419,0,716.2,9.25483870967742,3.64193548387097,9,11,21,21,62
"805",2016-03-15,62,55,7,8.68709677419355,8.50645161290323,0,588.6,10.3612903225806,6.55161290322581,6,14,17,25,62
"806",2016-03-16,53,43,10,3.18867924528302,8.28867924528302,0,514.7,12.5716981132075,4.00566037735849,9,11,17,16,53
"807",2016-03-17,48,37,11,0.3125,7.6375,0,497.4,10.9625,4.225,12,3,12,21,48
"808",2016-03-18,70,62,8,0.16,2.86,0,1059.8,7,-1.36,20,11,22,17,70
"809",2016-03-19,48,42,6,0.170833333333333,-1.52916666666667,0,937.4,1.06875,-4.04166666666667,12,6,11,19,48
"810",2016-03-20,65,61,4,0,-0.416923076923077,0,1197.1,2.09846153846154,-2.93230769230769,29,6,16,14,65
"811",2016-03-21,51,43,8,0,1.57058823529412,0,837.9,4.93137254901961,-1.88039215686275,12,7,21,11,51
"812",2016-03-22,63,48,15,0.344444444444444,1.82222222222222,0,1019.2,5.2,-1.55555555555556,7,17,24,15,63
"813",2016-03-23,59,47,12,0.825423728813559,2.44576271186441,0,917.7,5.03050847457627,-0.154237288135593,11,15,15,18,59
"814",2016-03-24,46,38,8,10.0304347826087,-0.347826086956522,0,844,0.826086956521739,-1.43478260869565,2,14,14,16,46
"815",2016-03-25,45,37,8,5.38,0.575555555555555,0,784.1,2.37111111111111,-1.30222222222222,8,11,11,15,45
"816",2016-03-26,64,54,10,0,2.034375,0,1021.8,5.540625,-1.571875,16,9,26,13,64
"817",2016-03-27,62,55,7,0,6.16774193548387,0,733.6,11.5096774193548,0.725806451612903,25,9,12,16,62
"818",2016-03-28,54,47,7,7.2,6.9,0,599.4,10.5,3.2,10,3,12,29,54
"819",2016-03-29,58,48,10,0.16551724137931,3.76896551724138,0,825.4,7.68620689655172,-0.16551724137931,8,11,15,24,58
"820",2016-03-30,44,39,5,0.245454545454545,5.46363636363636,0,551.6,10.2727272727273,0.636363636363636,2,4,22,16,44
"821",2016-03-31,49,42,7,24.9040816326531,11.2530612244898,0,330.6,14.2428571428571,8.1734693877551,10,13,12,14,49
"822",2016-04-01,88,73,15,0.184090909090909,8.48522727272727,0,837.3,12.6852272727273,4.19318181818182,20,9,17,31,77
"823",2016-04-02,64,53,11,1.35,1.775,0,1038.4,5.81875,-2.284375,23,4,24,13,64
"824",2016-04-03,46,42,4,0,3.5695652173913,0,663.8,5.82173913043478,0.319565217391304,16,6,9,15,46
"825",2016-04-04,59,40,19,4.45084745762712,-3.2,0,1250.8,-0.710169491525424,-5.67966101694915,12,9,21,17,59
"826",2016-04-05,57,46,11,0,-3.25087719298246,0,1211.3,0.221052631578947,-6.71578947368421,10,9,24,14,57
"827",2016-04-06,55,41,14,7.78363636363636,2.97090909090909,0,826.6,7.02727272727273,-1.17090909090909,5,10,12,28,55
"828",2016-04-07,55,37,18,0.327272727272727,4.08363636363636,0,765.4,8.25636363636364,-0.0890909090909091,8,9,23,15,55
"829",2016-04-08,51,48,3,0,1,0,867,4.98235294117647,-3,7,6,14,24,51
"830",2016-04-09,67,58,9,0,-2.22089552238806,0,1354.8,0.705970149253731,-5.05820895522388,23,13,11,20,67
"831",2016-04-10,52,42,10,6.87692307692308,-2.24615384615385,0,1052.8,1.45384615384615,-5.84615384615385,21,6,17,8,52
"832",2016-04-11,63,54,9,3.33809523809524,5.6968253968254,0,775.1,10.0619047619048,1.33174603174603,11,7,21,24,63
"833",2016-04-12,56,50,6,0.164285714285714,4.21071428571429,0,772.2,7.64285714285714,0.214285714285714,11,10,16,19,56
"834",2016-04-13,55,46,9,0,2.42363636363636,0,856.7,5.86,-1.02545454545455,6,1,23,25,55
"835",2016-04-14,70,53,17,0,5.84285714285714,0,851,8.13285714285714,1.44857142857143,10,9,23,28,70
"836",2016-04-15,58,52,6,0,8.39137931034483,0,557.3,12.2206896551724,4.54310344827586,8,9,16,25,58
"837",2016-04-16,78,66,12,0,11.7538461538462,0,487.2,15.9230769230769,7.48461538461538,22,12,14,30,78
"838",2016-04-17,72,60,12,0,14.2027777777778,0,273.4,20.0722222222222,8.24722222222222,18,9,21,24,72
"839",2016-04-18,62,55,7,0,16.2645161290323,0,107.6,23.0161290322581,9.41290322580645,7,10,15,30,62
"840",2016-04-19,66,63,3,0,11.2727272727273,0,444,15.3363636363636,7.2,11,17,17,21,66
"841",2016-04-20,63,54,9,0,10.2571428571429,0,487.8,13.9,6.51428571428571,9,12,20,22,63
"842",2016-04-21,58,42,16,1.16206896551724,11.2344827586207,0,392.4,14.201724137931,8.16724137931035,5,7,27,19,58
"843",2016-04-22,55,45,10,0.618181818181818,13.2909090909091,0,259,19.4909090909091,7,8,10,17,20,55
"844",2016-04-23,66,50,16,0,6.28181818181818,0,773.4,8.7,3.37272727272727,14,10,19,23,66
"845",2016-04-24,51,44,7,0,7.04117647058824,0,558.9,10.1764705882353,3.80588235294118,11,8,11,21,51
"846",2016-04-25,70,62,8,0.942857142857143,6.24285714285714,0,823,7.58571428571429,4.81428571428571,8,10,29,23,70
"847",2016-04-26,38,33,5,2.30263157894737,5.65789473684211,0,469,5.73421052631579,2.52236842105263,6,6,14,12,38
"848",2016-04-27,63,56,7,0,6.12380952380952,0,748.2,8.49047619047619,2.1,9,8,14,32,63
"849",2016-04-28,51,47,4,0,5.36862745098039,0,644.2,7.92941176470588,2.7156862745098,8,11,23,9,51
"850",2016-04-29,72,55,17,0,7.84166666666667,0,731.4,10,5.675,14,13,25,20,72
"851",2016-04-30,82,71,11,0,9.66341463414634,0,683.6,14.2463414634146,5.08048780487805,16,15,24,27,82
"852",2016-05-01,85,77,8,4.19176470588235,8.85058823529412,0,777.7,10.6094117647059,6.99176470588235,26,14,24,21,85
"853",2016-05-02,59,51,8,0.386440677966102,9.19661016949153,0,519.4,11.9016949152542,6.47796610169492,11,17,18,13,59
"854",2016-05-03,57,43,14,0,10.1070175438596,0,449.9,14.2719298245614,5.84210526315789,5,16,22,14,57
"855",2016-05-04,61,55,6,0,10.755737704918,0,441.9,14.7737704918033,6.72131147540984,10,12,25,14,61
"856",2016-05-05,50,40,10,0,12.98,0,251,16.73,9.23,5,12,21,12,50
"857",2016-05-06,78,68,10,0,15.1179487179487,0,224.8,20.5641025641026,9.57179487179487,10,14,23,31,78
"858",2016-05-07,75,55,20,0.048,12.952,0,378.6,17.58,8.24,25,3,23,24,75
"859",2016-05-08,78,67,11,1.84615384615385,9.76153846153846,0,642.6,14.3615384615385,5.06153846153846,11,10,15,20,56
"860",2016-05-09,46,40,6,0,9.58695652173913,0,387,15.0217391304348,4.13913043478261,10,9,9,18,46
"861",2016-05-10,39,34,5,0,11.3846153846154,0,258,15.6461538461538,7.11538461538462,7,4,7,21,39
"862",2016-05-11,74,52,22,0,12.9472972972973,0,373.9,17.2581081081081,8.53648648648649,11,11,18,34,74
"863",2016-05-12,74,61,13,0,15.5391891891892,0,182.1,20.4716216216216,10.6067567567568,21,9,25,19,74
"864",2016-05-13,69,55,14,6.66811594202899,17.2768115942029,0,49.9,21.1159420289855,13.3536231884058,3,15,23,28,69
"865",2016-05-14,56,44,12,4.71428571428571,10.1428571428571,0,440,15.9,4.38571428571429,17,7,14,18,56
"866",2016-05-15,52,42,10,0.732692307692308,6.24615384615385,0,611.2,9.25192307692308,3.15384615384615,12,5,12,23,52
"867",2016-05-16,47,43,4,2.87659574468085,10.4936170212766,0,352.8,18.4765957446808,2.41063829787234,8,5,20,14,47
"868",2016-05-17,55,49,6,0.0490909090909091,10.8345454545455,0,394.1,15.0836363636364,6.50181818181818,2,11,23,19,55
"869",2016-05-18,60,53,7,0,11.85,0,369,15.9333333333333,7.76666666666667,14,9,18,19,60
"870",2016-05-19,57,47,10,0,15.3315789473684,0,152.1,19.5,11.0631578947368,7,8,20,22,57
"871",2016-05-20,63,50,13,0,15.5904761904762,0,151.8,22.2380952380952,8.94285714285714,17,15,16,15,63
"872",2016-05-21,65,49,16,0,18.9692307692308,1.10769230769231,9,23.4692307692308,14.4615384615385,19,7,17,22,65
"873",2016-05-22,82,73,9,0,18.1853658536585,0.475609756097561,23.8,23.0024390243902,13.2682926829268,31,6,15,30,82
"874",2016-05-23,58,55,3,0,18.798275862069,0.844827586206897,2.7,24.4965517241379,13.1,13,3,12,30,58
"875",2016-05-24,51,38,13,0,20.9647058823529,2.96470588235294,0,28.3705882352941,13.5588235294118,4,10,17,20,51
"876",2016-05-25,58,50,8,0,23.248275862069,5.24827586206897,0,30.0310344827586,16.3655172413793,8,11,19,20,58
"877",2016-05-26,63,53,10,3.1,19.8809523809524,2.18571428571429,19.2,23.7285714285714,15.952380952381,12,16,21,14,63
"878",2016-05-27,54,42,12,0.0296296296296296,23.2740740740741,5.27407407407407,0,28.7148148148148,17.8296296296296,9,10,23,12,54
"879",2016-05-28,78,74,4,0,24.3307692307692,6.33076923076923,0,30.5653846153846,18.0961538461538,30,5,15,28,78
"880",2016-05-29,94,81,13,0,24.8127659574468,6.81276595744681,0,29.7606382978723,19.7648936170213,11,15,14,26,66
"881",2016-05-30,48,45,3,0,23.325,5.325,0,28.1875,18.3625,8,7,21,12,48
"882",2016-05-31,78,70,8,0,21.5,3.5,0,27.3230769230769,15.6769230769231,8,9,20,29,66
"883",2016-06-01,108,99,9,0,16.4583333333333,0,166.5,19.3212962962963,13.4953703703704,11,17,26,31,85
"884",2016-06-02,65,57,8,0,21.7138461538462,3.71384615384615,0,27.2353846153846,16.1815384615385,12,13,15,25,65
"885",2016-06-03,67,48,19,0,20.3507462686567,2.35074626865672,0,25.6537313432836,14.9477611940298,12,8,22,25,67
"886",2016-06-04,86,61,25,4.54418604651163,21.0883720930233,3.08837209302326,0,25.9116279069767,16.1720930232558,29,6,22,29,86
"887",2016-06-05,69,50,19,19.0057971014493,19.1608695652174,1.16086956521739,0,21.9289855072464,16.2927536231884,21,5,23,20,69
"888",2016-06-06,64,57,7,2.3078125,20.3734375,2.3828125,0.6,25.825,14.821875,13,19,14,18,64
"889",2016-06-07,36,36,0,0,15.7916666666667,0,79.5,20.55,11.025,10,1,16,9,36
"890",2016-06-08,61,46,15,0,11.5,0,396.5,14.7819672131148,8.2,7,9,19,26,61
"891",2016-06-09,57,51,6,0,14.4701754385965,0,201.2,20.8280701754386,8.11228070175439,8,6,24,19,57
"892",2016-06-10,72,57,15,0,16.2375,0,126.9,22.3,10.075,10,14,19,29,72
"893",2016-06-11,50,38,12,7.56,21.82,3.82,0,30.584,12.972,11,5,15,19,50
"894",2016-06-12,64,56,8,0,16.878125,0,71.8,19.79375,13.878125,22,4,16,22,64
"895",2016-06-13,62,57,5,0,15.6048387096774,0,148.5,19.4032258064516,11.708064516129,9,11,27,15,62
"896",2016-06-14,47,40,7,0,15.8382978723404,0,101.6,20.7957446808511,10.7893617021277,4,7,14,22,47
"897",2016-06-15,55,44,11,0.5,17.9872727272727,0.0963636363636364,6,24.1363636363636,11.8345454545455,9,10,15,21,55
"898",2016-06-16,46,39,7,0.8,20.2630434782609,2.26304347826087,0,25.4630434782609,15.0630434782609,7,11,13,15,46
"899",2016-06-17,48,44,4,0,21.8583333333333,3.85833333333333,0,28.575,15.1416666666667,6,5,17,20,48
"900",2016-06-18,73,64,9,0,23.2191780821918,5.21917808219178,0,29.7876712328767,16.5506849315069,21,9,14,29,73
"901",2016-06-19,80,72,8,0,24.58,6.58,0,31.22,17.94,31,14,12,23,80
"902",2016-06-20,71,54,17,0,25.2394366197183,7.23943661971831,0,31.5732394366197,18.9056338028169,14,7,20,30,71
"903",2016-06-21,63,54,9,0,20.5460317460317,2.54603174603175,0,26.6238095238095,14.468253968254,11,12,18,22,63
"904",2016-06-22,57,48,9,0,20.8,2.8,0,25.8631578947368,15.6473684210526,10,11,19,17,57
"905",2016-06-23,47,39,8,0,19.2234042553191,1.34042553191489,5.5,23.5808510638298,14.7659574468085,10,11,12,14,47
"906",2016-06-24,50,39,11,0,21.224,3.224,0,27.454,14.908,7,13,12,18,50
"907",2016-06-25,84,67,17,0,19.3,1.3,0,27.8833333333333,14.05,24,7,19,34,84
"908",2016-06-26,100,81,19,2.728,24.824,6.824,0,31.356,18.266,23,10,18,29,80
"909",2016-06-27,79,74,5,0,27.0544303797468,9.05443037974683,0,33.1430379746835,20.8658227848101,8,9,24,27,68
"910",2016-06-28,64,48,16,0,20.2375,2.2375,0,23.94375,16.5125,12,9,23,20,64
"911",2016-06-29,55,48,7,0,20.8818181818182,2.88181818181818,0,26.4163636363636,15.3472727272727,8,15,12,20,55
"912",2016-06-30,64,56,8,0,20.4,2.4,0,27.2625,13.45,14,15,11,24,64
"913",2016-07-01,85,78,7,5.32705882352941,18.7129411764706,0.712941176470588,0,22.8129411764706,14.6129411764706,32,13,20,20,85
"914",2016-07-02,86,72,14,0,19.8604651162791,1.86046511627907,0,26.4220930232558,13.2790697674419,26,1,19,19,65
"915",2016-07-03,70,61,9,0,21.6485714285714,3.65714285714286,0.6,28.5228571428571,14.7657142857143,20,11,19,20,70
"916",2016-07-04,68,44,24,0,21.9514705882353,3.95147058823529,0,28.575,15.25,15,9,20,24,68
"917",2016-07-05,61,48,13,0,24.9754098360656,6.97540983606557,0,30.6098360655738,19.3409836065574,10,4,22,25,61
"918",2016-07-06,50,46,4,0,25.72,7.72,0,31.8,19.556,8,8,18,16,50
"919",2016-07-07,74,68,6,3.82702702702703,25.4324324324324,7.43243243243243,0,30.0945945945946,20.75,10,15,24,25,74
"920",2016-07-08,58,50,8,0.689655172413793,24.5379310344828,6.53793103448276,0,28.5689655172414,20.5034482758621,15,13,8,22,58
"921",2016-07-09,60,54,6,1.55166666666667,23.39,5.39,0,27.5458333333333,19.2625,23,5,10,22,60
"922",2016-07-10,70,60,10,0,23.08,5.08,0,28.66,17.4,23,12,10,25,70
"923",2016-07-11,59,52,7,0,22.3322033898305,4.33220338983051,0,25.6881355932203,18.8966101694915,14,5,15,25,59
"924",2016-07-12,56,47,9,0,25.5875,7.5875,0,30.6642857142857,20.5107142857143,14,7,14,21,56
"925",2016-07-13,49,45,4,4.37142857142857,26.3285714285714,8.32857142857143,0,31.9928571428571,20.6642857142857,11,6,15,17,49
"926",2016-07-14,69,49,20,6.14782608695652,23.8782608695652,5.87826086956522,0,27.9347826086957,19.7217391304348,10,11,17,31,69
"927",2016-07-15,72,55,17,0,22.275,4.275,0,27.5361111111111,16.9138888888889,20,6,21,25,72
"928",2016-07-16,72,54,18,0,18.5708333333333,0.570833333333333,0,21.8222222222222,15.3194444444444,31,7,10,24,72
"929",2016-07-17,64,58,6,0,20.91875,2.91875,0,26.53125,15.225,27,9,15,13,64
"930",2016-07-18,84,69,15,0,24.95,6.95,0,31.1142857142857,18.6928571428571,13,17,28,26,84
"931",2016-07-19,42,29,13,0,21.3357142857143,3.33571428571429,0,26.9214285714286,15.6571428571429,7,3,15,17,42
"932",2016-07-20,63,38,25,0,20.9666666666667,2.96666666666667,0,27.3444444444444,14.5,7,8,20,28,63
"933",2016-07-21,47,40,7,0,24.9553191489362,6.95531914893617,0,31.2914893617021,18.5191489361702,6,5,21,15,47
"934",2016-07-22,73,52,21,0,28.258904109589,10.258904109589,0,35.4246575342466,21.0931506849315,18,8,28,19,73
"935",2016-07-23,72,64,8,0,27.85,9.85,0,33.5833333333333,22.0333333333333,21,7,19,25,72
"936",2016-07-24,72,59,13,0,24.0013888888889,6.00138888888889,0,25.9777777777778,21.925,11,9,7,20,47
"937",2016-07-25,51,45,6,17.7862745098039,26.5313725490196,8.53137254901961,0,31.9450980392157,21.1176470588235,12,8,14,17,51
"938",2016-07-26,78,64,14,0,23.6166666666667,5.61666666666667,0,28.8307692307692,18.4025641025641,20,5,14,19,58
"939",2016-07-27,41,31,10,3.86341463414634,26.3243902439024,8.32439024390244,0,33.15,19.4841463414634,5,6,16,14,41
"940",2016-07-28,66,51,15,0,25.2636363636364,7.26363636363636,0,29.1272727272727,21.3,13,12,19,22,66
"941",2016-07-29,55,45,10,4.18727272727273,23.0418181818182,5.04181818181818,0,26.8218181818182,19.2618181818182,8,6,14,27,55
"942",2016-07-30,85,72,13,0,22.6705882352941,4.67058823529412,0,26.4117647058824,19.0705882352941,27,18,16,24,85
"943",2016-07-31,54,46,8,3.48148148148148,21.9425925925926,3.94259259259259,0,24.5731481481481,19.3027777777778,20,7,9,18,54
"944",2016-08-01,87,78,9,0,23.7494252873563,5.74942528735632,0,27.435632183908,20.0505747126437,23,14,25,25,87
"945",2016-08-02,37,35,2,0,23.8324324324324,5.83243243243243,0,28.4810810810811,19.3945945945946,6,6,13,12,37
"946",2016-08-03,65,52,13,0,24.3538461538462,6.35384615384615,0,29.1492307692308,19.5276923076923,17,12,16,20,65
"947",2016-08-04,56,48,8,0,26.3803571428571,8.38035714285714,0,32.1571428571429,20.5035714285714,14,11,14,17,56
"948",2016-08-05,60,50,10,0,27.295,9.295,0,31.0666666666667,23.435,11,5,23,21,60
"949",2016-08-06,67,62,5,0,24.7641791044776,6.76417910447761,0,30.0388059701493,19.489552238806,16,12,17,22,67
"950",2016-08-07,66,53,13,0,23.7151515151515,5.71515151515152,0,28.7886363636364,18.6909090909091,13,14,16,23,66
"951",2016-08-08,43,37,6,0,23.5627906976744,5.56279069767442,0,28.6023255813953,18.5232558139535,11,6,11,15,43
"952",2016-08-09,56,48,8,0.208928571428571,24.8821428571429,6.88214285714286,0,30.6803571428571,19,8,10,16,22,56
"953",2016-08-10,54,44,10,0.0833333333333333,27.8833333333333,9.88333333333333,0,33.35,22.4166666666667,12,14,9,19,54
"954",2016-08-11,60,50,10,0,27.5133333333333,9.51333333333333,0,32.5333333333333,22.48,15,15,12,18,60
"955",2016-08-12,84,58,26,0,23.9,5.9,0,28.65,24.4428571428571,25,9,28,22,84
"956",2016-08-13,65,57,8,16.0353846153846,26,8,0,29.2907692307692,22.7092307692308,25,6,12,22,65
"957",2016-08-14,72,65,7,0,24.5541666666667,6.55416666666667,0,28.7694444444444,20.3388888888889,16,6,21,29,72
"958",2016-08-15,54,49,5,1.34814814814815,22.1722222222222,4.17222222222222,0,25.6611111111111,18.5833333333333,11,15,12,16,54
"959",2016-08-16,54,42,12,16.2592592592593,23.9,5.9,0,28.4111111111111,19.3037037037037,9,9,11,25,54
"960",2016-08-17,51,43,8,0,23.5588235294118,5.55882352941177,0,26.3411764705882,19.5411764705882,10,9,19,13,51
"961",2016-08-18,57,51,6,0,23.9508771929825,5.95087719298246,0,27.540350877193,20.2614035087719,10,2,28,17,57
"962",2016-08-19,51,40,11,0,24.7823529411765,6.78235294117647,0,29.1647058823529,20.3,13,4,13,21,51
"963",2016-08-20,82,70,12,2.61463414634146,25.8585365853659,7.85853658536585,0,30.7170731707317,20.9268292682927,11,1,14,30,56
"964",2016-08-21,61,50,11,1.70491803278689,22.3,4.3,0,27.1213114754098,17.3786885245902,17,7,13,24,61
"965",2016-08-22,50,41,9,0,19.35,1.35,0,24.5,14.19,7,8,18,17,50
"966",2016-08-23,51,37,14,0,21.7058823529412,3.70588235294118,0,27.4882352941176,15.8235294117647,13,8,7,23,51
"967",2016-08-24,37,35,2,0,23.4405405405405,5.44054054054054,0,29.0635135135135,17.7783783783784,6,9,10,12,37
"968",2016-08-25,69,60,9,13.4434782608696,26.095652173913,8.09565217391304,0,31.0260869565217,21.1536231884058,19,4,27,19,69
"969",2016-08-26,44,39,5,0,24.8,6.8,0,29.8454545454545,19.7409090909091,9,11,17,7,44
"970",2016-08-27,99,72,27,0,22.1474747474747,4.14747474747475,0,26.1707070707071,18.0242424242424,11,9,11,33,64
"971",2016-08-28,60,53,7,0,25.7,7.7,0,30.6833333333333,20.7166666666667,14,9,20,17,60
"972",2016-08-29,67,52,15,0,22.134328358209,4.13432835820895,0,26.2208955223881,18.0477611940298,11,5,18,33,67
"973",2016-08-30,45,30,15,0,23.2222222222222,5.22222222222222,0,28.2666666666667,18.1777777777778,4,4,14,23,45
"974",2016-08-31,65,47,18,0.267692307692308,23.3323076923077,5.33230769230769,0,28.4,18.1646153846154,10,3,24,28,65
"975",2016-09-01,72,61,11,0,20,2,0,23.8736111111111,16.1263888888889,20,18,13,21,72
"976",2016-09-02,56,50,6,0,18.9285714285714,0.928571428571429,0,23.3857142857143,14.4571428571429,8,9,19,20,56
"977",2016-09-03,74,65,9,0,19.1756756756757,1.17567567567568,0,23.0324324324324,15.3189189189189,29,6,14,25,74
"978",2016-09-04,74,61,13,0,19.1,1.1,0,23.627027027027,14.472972972973,26,6,13,29,74
"979",2016-09-05,66,60,6,0,22.5318181818182,4.53181818181818,0,28.7590909090909,16.2909090909091,22,15,11,18,66
"980",2016-09-06,59,51,8,0,25.0084745762712,7.00847457627119,0,30.4966101694915,19.5203389830508,9,8,19,23,59
"981",2016-09-07,64,54,10,29.05,27.56875,9.56875,0,33.959375,21.178125,9,9,18,17,53
"982",2016-09-08,60,51,9,4.025,26.4166666666667,8.41666666666667,0,30.2916666666667,22.4416666666667,6,13,27,14,60
"983",2016-09-09,64,60,4,0,24.271875,6.271875,0,27.903125,20.540625,11,8,22,23,64
"984",2016-09-10,81,66,15,4.63456790123457,23.9654320987654,5.96543209876543,0,28.5753086419753,19.2728395061728,25,10,21,25,81
"985",2016-09-11,64,54,10,0,18.878125,0.878125,0,23.346875,14.39375,24,10,12,18,64
"986",2016-09-12,59,48,11,0,18.4796610169492,0.479661016949153,0,23.7389830508475,13.1305084745763,14,5,18,22,59
"987",2016-09-13,56,48,8,0,21.3464285714286,3.34642857142857,0,27.2071428571429,15.4857142857143,4,11,27,14,56
"988",2016-09-14,57,45,12,0,18.9368421052632,0.936842105263158,0,23.1,14.6859649122807,13,10,15,19,57
"989",2016-09-15,53,46,7,0,15.8,0,116.6,19.7339622641509,11.8660377358491,4,9,20,20,53
"990",2016-09-16,49,43,6,0,18.0591836734694,0.0918367346938776,1.6,22.5612244897959,13.4571428571429,6,7,11,25,49
"991",2016-09-17,83,64,19,10.8493975903614,20.8831325301205,2.88313253012048,0,22.466265060241,19.3,17,10,26,30,83
"992",2016-09-18,82,72,10,0,21.1731707317073,3.17317073170732,0,24.9414634146341,17.3390243902439,27,9,19,27,82
"993",2016-09-19,52,40,12,0,20.9076923076923,2.90769230769231,0,25.4596153846154,16.3653846153846,17,10,11,14,52
"994",2016-09-20,56,51,5,0,22.1964285714286,4.19642857142857,0,27.5714285714286,16.7392857142857,3,11,22,20,56
"995",2016-09-21,65,53,12,0,20.5769230769231,2.57692307692308,0,26.3384615384615,14.7307692307692,9,8,24,24,65
"996",2016-09-22,58,46,12,0,19.1,1.1,0,23.2,16.7137931034483,9,12,22,15,58
"997",2016-09-23,50,42,8,0.288,17.776,0,11.2,23.128,12.332,18,9,12,11,50
"998",2016-09-24,68,61,7,0,14.2352941176471,0,256,18.6058823529412,9.85294117647059,16,7,20,25,68
"999",2016-09-25,62,58,4,0,13.6693548387097,0,268.5,16.8645161290323,10.4403225806452,22,8,13,19,62
"1000",2016-09-26,62,53,9,10.141935483871,16.0887096774194,0,118.5,18.3467741935484,13.8096774193548,12,13,20,17,62
"1001",2016-09-27,63,57,6,0,16.2063492063492,0,113,21.2,11.1126984126984,7,9,24,23,63
"1002",2016-09-28,54,48,6,0,18.5518518518519,0.551851851851852,0,22.3333333333333,14.7703703703704,3,8,30,13,54
"1003",2016-09-29,52,47,5,4.18653846153846,16.2769230769231,0,89.6,18.2673076923077,14.2769230769231,9,4,24,15,52
"1004",2016-09-30,66,56,10,0,16.4924242424242,0,99.5,19.069696969697,13.9075757575758,9,10,18,29,66
"1005",2016-10-01,100,89,11,0.227,15.018,0,298.2,16.527,13.418,11,14,25,17,67
"1006",2016-10-02,67,58,9,2.88955223880597,17.4,0,40.2,19.665671641791,15.034328358209,29,3,22,13,67
"1007",2016-10-03,55,49,6,0,15.9272727272727,0,114,18.2272727272727,13.3727272727273,8,7,22,18,55
"1008",2016-10-04,43,35,8,0,17.7232558139535,0,11.9,19.5511627906977,15.8883720930233,6,10,11,16,43
"1009",2016-10-05,57,41,16,0,17.4912280701754,0,29,20.1035087719298,14.8789473684211,7,5,27,18,57
"1010",2016-10-06,48,42,6,0,19.75,1.75,0,22.69375,16.70625,10,13,15,10,48
"1011",2016-10-07,47,38,9,0,18.9617021276596,0.961702127659574,0,22.2595744680851,15.563829787234,6,8,9,24,47
"1012",2016-10-08,57,55,2,2.57719298245614,14.3175438596491,0,209.9,19.6,9.01754385964912,13,10,19,15,57
"1013",2016-10-09,70,59,11,0,9.98,0,561.4,13.44,6.42,25,10,14,21,70
"1014",2016-10-10,37,33,4,0,8.33243243243243,0,357.7,12.5891891891892,3.98648648648649,10,4,15,8,37
"1015",2016-10-11,56,37,19,0,11.65,0,355.6,17.3375,5.9625,8,13,20,15,56
"1016",2016-10-12,60,51,9,0,17.0866666666667,0,54.8,21.7066666666667,12.38,5,13,19,23,60
"1017",2016-10-13,56,50,6,0,13.1125,0,273.7,19.8,6.3375,12,11,18,15,56
"1018",2016-10-14,59,53,6,0,10.2796610169492,0,455.5,14.7101694915254,5.7593220338983,7,14,17,21,59
"1019",2016-10-15,80,64,16,0,14.70625,0,263.5,18.73625,10.57625,29,16,11,24,80
"1020",2016-10-16,72,61,11,1.38055555555556,19.4611111111111,1.46111111111111,0,21.4708333333333,17.4513888888889,32,8,16,16,72
"1021",2016-10-17,68,53,15,0.767647058823529,17.3558823529412,0,43.8,19.7176470588235,14.6441176470588,12,13,18,25,68
"1022",2016-10-18,60,51,9,0,18.855,1.045,11.4,24.53,12.995,8,13,13,26,60
"1023",2016-10-19,63,51,12,0,15.6,0,151.2,19.5428571428571,11.5714285714286,16,13,19,15,63
"1024",2016-10-20,69,52,17,6.09275362318841,13.8463768115942,0,286.6,16.2884057971015,11.3927536231884,4,7,34,24,69
"1025",2016-10-21,48,43,5,5.175,8.91666666666667,0,436,11.725,6.0125,9,15,10,14,48
"1026",2016-10-22,76,60,16,0,6.55263157894737,0,870,8.87368421052632,4.23157894736842,25,9,23,19,76
"1027",2016-10-23,80,60,20,0,9.47,0,682.4,14.04875,4.87,11,9,17,18,55
"1028",2016-10-24,55,45,10,0,8.32909090909091,0,531.9,10.6436363636364,5.91454545454545,11,8,24,12,55
"1029",2016-10-25,56,52,4,0,7.42857142857143,0,592,9.78571428571429,4.72857142857143,7,12,18,19,56
"1030",2016-10-26,61,45,16,0,4.29508196721311,0,836,6.94098360655738,1.43770491803279,4,10,16,31,61
"1031",2016-10-27,54,44,10,9.17222222222222,3.89074074074074,0,761.9,6.69074074074074,1.07777777777778,7,11,23,13,54
"1032",2016-10-28,55,50,5,0,5.92727272727273,0,664,10.7363636363636,1.11818181818182,9,7,23,16,55
"1033",2016-10-29,66,57,9,0,15.3136363636364,0,177.3,19.8090909090909,10.7227272727273,29,9,10,18,66
"1034",2016-10-30,68,61,7,0.423529411764706,9.4,0,584.8,13.6176470588235,4.65294117647059,11,8,10,16,45
"1035",2016-10-31,88,70,18,0,7.23181818181818,0,947.6,10.8636363636364,3.21022727272727,13,7,19,19,58
"1036",2016-11-01,70,63,7,0,12.4642857142857,0,387.5,17.8071428571429,7.02142857142857,20,12,16,22,70
"1037",2016-11-02,56,46,10,4.325,15.9821428571429,0,113,19.3464285714286,12.5178571428571,10,11,15,20,56
"1038",2016-11-03,58,50,8,20.9172413793103,10.8310344827586,0,415.8,14.4362068965517,7.12586206896552,3,5,24,26,58
"1039",2016-11-04,69,55,14,0,8.27826086956522,0,670.8,12.1782608695652,4.37826086956522,12,4,22,31,69
"1040",2016-11-05,71,63,8,0,11.8183098591549,0,438.9,16.1788732394366,7.45774647887324,16,7,20,28,71
"1041",2016-11-06,63,56,7,0,9.28571428571429,0,549,12.2,6.28571428571429,18,8,26,11,63
"1042",2016-11-07,49,41,8,0,10.4265306122449,0,371.1,15.4897959183673,5.26326530612245,3,8,25,13,49
"1043",2016-11-08,43,36,7,0.744186046511628,10.9906976744186,0,301.4,15.5697674418605,6.36046511627907,3,6,13,21,43
"1044",2016-11-09,50,37,13,0,8.128,0,493.6,12.428,6.556,5,9,17,19,50
"1045",2016-11-10,52,38,14,0,9.16153846153846,0,459.6,16.3461538461538,1.97692307692308,6,10,22,14,52
"1046",2016-11-11,62,52,10,0,6.83870967741935,0,692,13.0096774193548,0.658064516129032,8,11,19,24,62
"1047",2016-11-12,55,46,9,0,4.80909090909091,0,725.5,10.1,-0.481818181818182,15,7,17,16,55
"1048",2016-11-13,60,38,22,0,7.68,0,619.2,12.16,3.18,29,9,9,13,60
"1049",2016-11-14,62,53,9,0,8.98387096774194,0,559,12.7516129032258,5.20806451612903,9,17,19,17,62
"1050",2016-11-15,46,38,8,0,8.69130434782609,0,428.2,12.604347826087,4.77826086956522,6,9,22,9,46
"1051",2016-11-16,60,52,8,0,10.0333333333333,0,478,13.6916666666667,6.33333333333333,10,10,22,18,60
"1052",2016-11-17,62,47,15,0,8.10967741935484,0,613.2,11.5967741935484,4.68064516129032,6,9,19,16,50
"1053",2016-11-18,72,55,17,0,12.4208333333333,0,401.7,17.4333333333333,7.30833333333333,9,11,16,19,55
"1054",2016-11-19,65,53,12,3.41846153846154,8.09230769230769,0,644,14.9630769230769,1.21076923076923,26,7,13,19,65
"1055",2016-11-20,65,59,6,2.12,1.59538461538462,0,1066.3,4.50923076923077,-1.28923076923077,23,13,11,18,65
"1056",2016-11-21,56,43,13,0,-0.485714285714286,0,1035.2,1.54285714285714,-2.44285714285714,5,7,25,19,56
"1057",2016-11-22,63,51,12,0,0.550793650793651,0,1099.3,2.98888888888889,-1.98730158730159,11,14,25,13,63
"1058",2016-11-23,49,39,10,1.93673469387755,0.248979591836735,0,869.8,2.4469387755102,-2.04897959183673,9,8,21,11,49
"1059",2016-11-24,56,49,7,2.22142857142857,3.44285714285714,0,815.2,4.43571428571429,2.35714285714286,7,12,19,18,56
"1060",2016-11-25,75,65,10,1.32533333333333,5.928,0,905.4,8.14533333333333,3.74266666666667,2,17,18,20,57
"1061",2016-11-26,65,48,17,4.26923076923077,5.34307692307692,0,822.7,7.38615384615385,3.22153846153846,31,3,14,17,65
"1062",2016-11-27,70,62,8,0,6.16285714285714,0,828.6,8.78,3.61428571428571,23,9,18,20,70
"1063",2016-11-28,58,45,13,0.482758620689655,6.55862068965517,0,663.6,8.25172413793103,4.78965517241379,6,7,27,18,58
"1064",2016-11-29,57,42,15,2.30701754385965,9.65964912280702,0,475.4,13.0105263157895,6.30175438596491,6,7,26,18,57
"1065",2016-11-30,70,59,11,5.57142857142857,10.15,0,549.5,12.5,7.75,6,15,23,26,70
"1066",2016-12-01,81,69,12,0.00864197530864198,6.12469135802469,0,961.9,7.92469135802469,4.20802469135802,18,17,23,23,81
"1067",2016-12-02,48,41,7,0,4.70833333333333,0,638,6.7125,2.70208333333333,4,8,11,25,48
"1068",2016-12-03,70,60,10,0,4.03428571428571,0,977.6,6.74571428571429,1.32285714285714,23,8,23,16,70
"1069",2016-12-04,74,60,14,2.04324324324324,2.35675675675676,0,1157.6,3.91891891891892,0.775675675675676,29,7,14,24,74
"1070",2016-12-05,43,31,12,4.41395348837209,3.95813953488372,0,603.8,6.35813953488372,1.55813953488372,7,7,17,12,43
"1071",2016-12-06,43,38,5,5.06046511627907,3.84651162790698,0,608.6,5.97209302325581,1.63488372093023,5,8,14,16,43
"1072",2016-12-07,58,46,12,0,2.14827586206897,0,919.4,3.94827586206897,0.336206896551724,5,10,28,15,58
"1073",2016-12-08,56,45,11,0.492857142857143,-0.682142857142857,0,1046.2,1.05357142857143,-2.4,9,12,15,20,56
"1074",2016-12-09,72,66,6,0,-3.3125,0,1534.5,-0.0875,-6.45,8,13,18,13,52
"1075",2016-12-10,49,36,13,0,-3.56734693877551,0,1056.8,-0.683673469387755,-6.35102040816327,14,13,10,12,49
"1076",2016-12-11,60,52,8,9.76,-1.35333333333333,0,1161.2,1.13666666666667,-4.08166666666667,20,7,18,15,60
"1077",2016-12-12,68,47,21,4.49705882352941,1.28529411764706,0,1136.6,3.27058823529412,-0.707352941176471,11,11,16,30,68
"1078",2016-12-13,46,38,8,0,-2.7,0,952.2,-0.1,-5.2,5,11,14,16,46
"1079",2016-12-14,52,48,4,0,-6.57884615384615,0,1278.1,-3.97884615384615,-9.09615384615384,7,5,25,15,52
"1080",2016-12-15,52,44,8,2.79230769230769,-6.82307692307692,0,1290.8,-4.48461538461538,-9.47307692307692,4,14,16,18,52
"1081",2016-12-16,49,42,7,3.58775510204082,-7.05102040816327,0,1227.5,-4.67551020408163,-9.33469387755102,4,7,25,13,49
"1082",2016-12-17,65,56,9,8.46923076923077,-2.6,0,1339,0.5,-5.69230769230769,25,9,11,8,53
"1083",2016-12-18,71,69,2,1.64647887323944,-5.25774647887324,0,1651.3,-0.0859154929577465,-10.343661971831,26,7,22,16,71
"1084",2016-12-19,49,43,6,0.0102040816326531,-6.80204081632653,0,1215.3,-5.36122448979592,-8.38061224489796,8,10,17,14,49
"1085",2016-12-20,46,38,8,0,-2.94347826086957,0,963.4,1.30434782608696,-7.09130434782609,7,11,14,14,46
"1086",2016-12-21,45,39,6,1.38222222222222,-1.61111111111111,0,882.5,1.26444444444444,-4.38666666666667,9,8,10,18,45
"1087",2016-12-22,45,36,9,0.155555555555556,2.47777777777778,0,698.5,4.12222222222222,0.755555555555556,13,6,12,14,45
"1088",2016-12-23,77,66,11,0,1.3,0,1285.9,3.64155844155844,-1.05324675324675,16,12,13,19,60
"1089",2016-12-24,79,66,13,3.91139240506329,3.18860759493671,0,1170.1,4.65443037974684,1.71139240506329,29,8,17,25,79
"1090",2016-12-25,41,36,5,0,0.84390243902439,0,703.4,3.81463414634146,-2.14146341463415,15,6,5,15,41
"1091",2016-12-26,40,35,5,14.0875,4.1125,0,555.5,10.0625,-1.925,10,6,12,12,40
"1092",2016-12-27,48,39,9,0.4375,3.275,0,706.8,8.4375,-1.975,10,11,17,10,48
"1093",2016-12-28,40,37,3,0,-0.49,0,739.6,1.49,-2.37,7,10,14,9,40
"1094",2016-12-29,49,43,6,8.41632653061225,1.42244897959184,0,812.3,2.82244897959184,-0.0551020408163265,17,7,9,16,49
"1095",2016-12-30,60,48,12,0.606666666666667,-0.686666666666667,0,1121.2,0.913333333333333,-2.28666666666667,14,8,19,19,60
"1096",2016-12-31,72,62,10,0.344444444444444,1.17638888888889,0,1211.3,3.22083333333333,-2.22361111111111,12,11,21,28,72
"1097",2017-01-01,157,144,13,0,1.10636942675159,0,2652.3,3.03885350318471,-0.68343949044586,11,14,18,21,64
"1098",2017-01-02,53,48,5,0,2.98679245283019,0,795.7,5.42075471698113,0.552830188679245,15,4,22,12,53
"1099",2017-01-03,41,33,8,11.319512195122,3.61463414634146,0,589.8,4.81463414634146,2.41463414634146,11,6,19,5,41
"1100",2017-01-04,40,28,12,0.58,-1.82,0,792.8,3.9,-7.52,5,6,8,21,40
"1101",2017-01-05,33,28,5,0,-7.74545454545455,0,849.6,-5.26363636363636,-10.2272727272727,6,3,10,14,33
"1102",2017-01-06,56,39,17,0,-8.87857142857143,0,1505.2,-5.87857142857143,-11.7785714285714,9,8,14,25,56
"1103",2017-01-07,44,33,11,0,-9.12045454545454,0,1193.3,-6.37954545454545,-11.8613636363636,13,9,7,15,44
"1104",2017-01-08,55,43,12,0,-9.64909090909091,0,1520.7,-8.13636363636363,-11.0618181818182,18,8,15,14,55
"1105",2017-01-09,45,40,5,0,-4.82222222222222,0,1027,-1.15333333333333,-8.39111111111111,8,12,7,18,45
"1106",2017-01-10,44,39,5,15.8045454545455,2.37954545454545,0,687.3,6.51363636363636,-1.65909090909091,4,7,16,17,44
"1107",2017-01-11,56,45,11,3.99285714285714,4.76071428571429,0,741.4,7.81428571428571,1.66428571428571,6,5,24,21,56
"1108",2017-01-12,47,39,8,15.8042553191489,4.33191489361702,0,642.4,9.65531914893617,-1,4,7,10,26,47
"1109",2017-01-13,56,43,13,0,-4.18928571428571,0,1242.6,-0.6,-7.775,5,14,19,18,56
"1110",2017-01-14,52,44,8,0,-5.28269230769231,0,1210.7,-2.15192307692308,-8.41346153846154,10,5,16,21,52
"1111",2017-01-15,54,50,4,0,-2,0,1080,0.487037037037037,-4.38703703703704,11,6,17,20,54
"1112",2017-01-16,51,36,15,0,-0.219607843137255,0,929.2,3.63137254901961,-3.97058823529412,8,4,23,16,51
"1113",2017-01-17,38,34,4,13.6263157894737,1.81578947368421,0,615,2.6,1.01052631578947,4,8,17,9,38
"1114",2017-01-18,60,46,14,0.366666666666667,2.9625,0,902.25,4.35833333333333,1.53333333333333,3,4,27,26,60
"1115",2017-01-19,41,33,8,0,3.09512195121951,0,611.1,4.19024390243902,1.99512195121951,3,11,13,14,41
"1116",2017-01-20,56,40,16,0,3.07857142857143,0,835.6,4.18392857142857,1.87321428571429,10,4,14,28,56
"1117",2017-01-21,64,53,11,0,4.89375,0,838.8,6.390625,3.3796875,17,7,18,22,64
"1118",2017-01-22,67,57,10,0,4.07313432835821,0,933.1,5.64626865671642,2.5,28,10,16,13,67
"1119",2017-01-23,85,71,14,0,2.76705882352941,0,1294.8,4.35058823529412,1.16705882352941,24,9,23,12,68
"1120",2017-01-24,56,41,15,0.410714285714286,0.966071428571429,0,953.9,2.06071428571429,-0.00357142857142856,4,15,24,13,56
"1121",2017-01-25,57,44,13,2.46315789473684,3.23947368421053,0,841.35,5.35789473684211,1.15789473684211,9,14,21,13,57
"1122",2017-01-26,43,33,10,2.16744186046512,3.16744186046512,0,637.8,4.73488372093023,1.5,9,6,10,18,43
"1123",2017-01-27,56,42,14,0.2625,0.975,0,953.4,2.2375,-0.2875,13,14,13,16,56
"1124",2017-01-28,66,57,9,0.625757575757576,-0.878787878787879,0,1246,-0.178787878787879,-1.47878787878788,15,4,30,17,66
"1125",2017-01-29,78,67,11,0,-3.5,0,1677,-1,-5.9,29,12,15,22,78
"1126",2017-01-30,62,50,12,0,-7.06612903225806,0,1554.1,-3.95645161290323,-10.0758064516129,9,10,20,23,62
"1127",2017-01-31,60,50,10,1.98,-3.12,0,1267.2,-1.52,-4.64,9,15,20,16,60
"1128",2017-02-01,91,81,10,0,0.146153846153846,0,1624.7,3.63076923076923,-3.33846153846154,17,13,18,26,74
"1129",2017-02-02,61,49,12,0.183606557377049,-3.69180327868852,0,1323.2,-1.58360655737705,-5.7,8,8,17,28,61
"1130",2017-02-03,53,34,19,0,-5.63962264150943,0,1252.9,-3.3,-7.89433962264151,4,10,22,17,53
"1131",2017-02-04,60,49,11,0,-3.74666666666667,0,1304.8,-0.233333333333333,-7.24666666666667,16,7,22,15,60
"1132",2017-02-05,56,48,8,0.546428571428571,-0.6,0,1041.6,1.39107142857143,-2.49107142857143,15,8,9,24,56
"1133",2017-02-06,53,46,7,0,-0.9,0,1001.7,1.99056603773585,-3.69056603773585,6,12,20,15,53
"1134",2017-02-07,45,37,8,14.9733333333333,1.82,0,728.1,4.81333333333333,-1.17333333333333,5,8,16,16,45
"1135",2017-02-08,78,64,14,0,-1.38076923076923,0,1511.7,4.42564102564103,-7.08717948717949,15,15,30,18,78
"1136",2017-02-09,28,25,3,0.171428571428571,-7.47142857142857,0,713.2,-3.88571428571429,-11.0571428571429,7,5,11,5,28
"1137",2017-02-10,55,46,9,4.29090909090909,-3.40909090909091,0,1177.5,-0.0909090909090909,-6.64545454545455,7,12,23,13,55
"1138",2017-02-11,65,56,9,0,1.63846153846154,0,1063.5,4.84615384615385,-1.56923076923077,12,6,19,28,65
"1139",2017-02-12,64,58,6,13.18125,-0.7578125,0,1200.5,2.240625,-3.6015625,22,2,23,17,64
"1140",2017-02-13,50,36,14,0,-1.888,0,994.4,-0.112,-3.504,6,9,17,18,50
"1141",2017-02-14,83,70,13,0,0.989156626506024,0,1411.9,5.5566265060241,-3.58192771084337,19,14,24,26,83
"1142",2017-02-15,57,51,6,0,-1.12105263157895,0,1089.9,2.92631578947368,-5.07894736842105,8,6,28,15,57
"1143",2017-02-16,46,39,7,0,-5.71304347826087,0,1090.8,-2.29565217391304,-9.1304347826087,2,14,20,10,46
"1144",2017-02-17,55,48,7,0,-2.4,0,1122,1.46363636363636,-6.24545454545455,14,14,10,17,55
"1145",2017-02-18,64,59,5,0,6.6453125,0,726.7,13.6734375,-0.396875,27,5,12,20,64
"1146",2017-02-19,73,66,7,0,8.27534246575343,0,709.9,13.2287671232877,3.3041095890411,27,7,22,17,73
"1147",2017-02-20,57,48,9,0,2.5280701754386,0,881.9,4.34385964912281,0.640350877192982,17,10,11,19,57
"1148",2017-02-21,51,46,5,2.16470588235294,4.39803921568627,0,693.7,7.05294117647059,1.72156862745098,8,7,15,21,51
"1149",2017-02-22,67,51,16,0,7.14925373134328,0,727,9.60149253731343,4.6089552238806,2,18,24,23,67
"1150",2017-02-23,45,35,10,0,12.0466666666667,0,267.9,19.02,5.07333333333333,5,11,13,16,45
"1151",2017-02-24,64,50,14,2.109375,4.215625,0,882.2,5.415625,3,7,10,30,17,64
"1152",2017-02-25,69,57,12,7.51739130434783,3.68260869565217,0,987.9,8.76521739130435,-1.48260869565217,26,7,19,17,69
"1153",2017-02-26,54,47,7,0,0.4,0,950.4,3.53888888888889,-2.8,12,9,22,11,54
"1154",2017-02-27,58,46,12,0,6.20862068965517,0,683.9,9.91724137931035,2.5,9,9,25,15,58
"1155",2017-02-28,53,43,10,1.8377358490566,6.81509433962264,0,592.8,10.8150943396226,2.80566037735849,5,5,26,17,53
"1156",2017-03-01,99,92,7,18.3676767676768,5.46262626262626,0,1241.2,12.8414141414141,-1.92424242424242,11,13,30,20,74
"1157",2017-03-02,66,44,22,0.166666666666667,-2.98333333333333,0,1384.9,-0.425,-5.78333333333333,11,17,18,20,66
"1158",2017-03-03,52,44,8,0,-6.2,0,1258.4,-4.28846153846154,-8.11153846153846,4,12,19,17,52
"1159",2017-03-04,52,41,11,0.153846153846154,-9.10769230769231,0,1409.6,-6.40769230769231,-11.8076923076923,16,7,14,15,52
"1160",2017-03-05,54,47,7,0,-5.38888888888889,0,1263,-0.333333333333333,-10.4444444444444,11,15,13,15,54
"1161",2017-03-06,51,44,7,0,1.6,0,836.4,4.80686274509804,-2.7,6,10,21,14,51
"1162",2017-03-07,39,33,6,9.53589743589744,8.54615384615385,0,368.7,10.7846153846154,6.20769230769231,5,4,15,15,39
"1163",2017-03-08,48,40,8,0,5.93333333333333,0,579.2,9.90833333333333,1.55,7,7,22,12,48
"1164",2017-03-09,51,45,6,0,1.67254901960784,0,832.7,4.31764705882353,-1.07254901960784,10,5,19,17,51
"1165",2017-03-10,48,37,11,0,-4.89166666666667,0,1098.8,-0.291666666666667,-9.4,12,17,11,8,48
"1166",2017-03-11,63,49,14,0.184126984126984,-8.88412698412698,0,1693.7,-5.29206349206349,-12.4761904761905,11,10,17,25,63
"1167",2017-03-12,55,51,4,0,-8.16363636363636,0,1439,-3.78181818181818,-12.4636363636364,22,3,14,16,55
"1168",2017-03-13,48,39,9,0.916666666666667,-7.86666666666667,0,1241.6,-5.475,-10.1583333333333,8,17,11,12,48
"1169",2017-03-14,34,26,8,1.98529411764706,-8.57352941176471,0,903.5,-7,-10.1205882352941,2,6,7,19,34
"1170",2017-03-15,46,37,9,0.169565217391304,-6.15434782608696,0,1111.1,-2.8695652173913,-9.35434782608696,9,9,7,21,46
"1171",2017-03-16,37,32,5,0,-1.87567567567568,0,735.4,2.99189189189189,-6.74324324324324,5,6,12,14,37
"1172",2017-03-17,55,50,5,0,0.736363636363636,0,949.5,5.21090909090909,-3.82545454545455,13,8,13,21,55
"1173",2017-03-18,75,61,14,1,1.6,0,1230,3.38333333333333,-0.833333333333333,29,10,19,17,75
"1174",2017-03-19,60,49,11,0,3.13,0,892.2,6.0325,-0.15,19,8,10,23,60
"1175",2017-03-20,47,41,6,0,3.09148936170213,0,700.7,5.28723404255319,0.795744680851064,8,14,13,12,47
"1176",2017-03-21,59,53,6,0,5.39322033898305,0,743.8,13.4661016949153,-2.67966101694915,7,7,27,18,59
"1177",2017-03-22,56,52,4,0,-4.99285714285714,0,1287.6,-1.59642857142857,-8.28928571428571,9,13,20,14,56
"1178",2017-03-23,58,52,6,0,-2.38103448275862,0,1182.1,2.2,-6.88103448275862,6,12,21,19,58
"1179",2017-03-24,82,68,14,7.00853658536585,6.70365853658537,0,926.3,11.9512195121951,1.35609756097561,16,12,25,29,82
"1180",2017-03-25,57,44,13,7.11754385964912,3.15263157894737,0,846.3,4.55263157894737,1.73508771929825,16,10,11,20,57
"1181",2017-03-26,61,55,6,2.42131147540984,3.85737704918033,0,862.7,6.42950819672131,1.20655737704918,21,10,11,19,61
"1182",2017-03-27,54,44,10,1.77777777777778,10.2851851851852,0,416.6,14.3296296296296,6.15925925925926,3,6,25,20,54
"1183",2017-03-28,59,49,10,0,6.5,0,678.5,9.63898305084746,2.94745762711864,13,9,26,11,59
"1184",2017-03-29,50,41,9,0,6.288,0,585.6,8.988,3.588,8,9,20,13,50
"1185",2017-03-30,49,40,9,10.2408163265306,2.25510204081633,0,771.5,3.73265306122449,0.7,8,6,25,10,49
"1186",2017-03-31,52,45,7,10.1461538461538,3.01730769230769,0,779.1,4.10576923076923,1.82884615384615,4,8,15,25,52
"1187",2017-04-01,100,89,11,0,6.82,0,1118,11.32,2.24,27,15,27,31,100
"1188",2017-04-02,71,67,4,0,10.1985915492958,0,553.9,16.6323943661972,3.66478873239437,21,8,24,18,71
"1189",2017-04-03,54,42,12,6.63333333333333,7.85555555555556,0,547.8,10.3555555555556,5.25555555555556,10,11,11,22,54
"1190",2017-04-04,35,32,3,9.04,7.78,0,357.7,10.76,5.01,6,6,17,6,35
"1191",2017-04-05,62,53,9,0.174193548387097,7.03548387096774,0,679.8,9.04516129032258,5.01290322580645,9,10,18,25,62
"1192",2017-04-06,52,48,4,24.3134615384615,4.84615384615385,0,684,7.95192307692308,1.75096153846154,13,13,12,14,52
"1193",2017-04-07,81,62,19,1.18518518518519,2.71851851851852,0,1237.8,5.22592592592593,0.111111111111111,11,13,32,25,81
"1194",2017-04-08,72,56,16,0.161111111111111,6.34444444444444,0,839.2,11.7916666666667,0.897222222222222,20,7,19,26,72
"1195",2017-04-09,90,74,16,0,11.1588888888889,0,615.7,17.6966666666667,4.62111111111111,30,13,23,24,90
"1196",2017-04-10,44,40,4,1.45454545454545,16.6204545454545,0,60.7,21.7409090909091,11.4931818181818,7,11,13,13,44
"1197",2017-04-11,73,63,10,0,8.1,0,722.7,12.2,10.7006849315068,10,15,27,21,73
"1198",2017-04-12,65,56,9,0,6.48769230769231,0,748.3,9.47538461538462,3.4,18,12,16,19,65
"1199",2017-04-13,58,49,9,0,7.16724137931034,0,628.3,11.8465517241379,2.38793103448276,11,13,14,20,58
"1200",2017-04-14,66,59,7,0,10.369696969697,0,503.6,14.5363636363636,6.19090909090909,24,10,23,9,66
"1201",2017-04-15,62,45,17,3.74354838709677,10.5790322580645,0,460.1,15.6741935483871,5.38387096774194,17,5,13,27,62
"1202",2017-04-16,66,54,12,0.166666666666667,16.4,0,105.6,22.1666666666667,10.6166666666667,26,11,12,17,66
"1203",2017-04-17,49,42,7,0,7.96326530612245,0,491.8,13.334693877551,2.59183673469388,8,3,10,28,49
"1204",2017-04-18,61,50,11,0,4.98196721311475,0,794.1,8.06393442622951,1.81311475409836,14,6,19,22,61
"1205",2017-04-19,88,75,13,1.06363636363636,12.0886363636364,0,520.2,18.9363636363636,5.36022727272727,14,16,23,35,88
"1206",2017-04-20,59,52,7,18.9559322033898,7.44915254237288,0,622.5,10.4101694915254,4.68389830508475,9,11,20,19,59
"1207",2017-04-21,63,52,11,0,9.92380952380952,0,508.8,13.8730158730159,5.97460317460317,6,10,18,29,63
"1208",2017-04-22,73,57,16,0,9.39452054794521,0,628.2,13.558904109589,5.23013698630137,21,9,19,24,73
"1209",2017-04-23,74,60,14,0,11.272972972973,0,497.8,17.8797297297297,4.65135135135135,25,11,16,22,74
"1210",2017-04-24,53,44,9,0,8.84716981132076,0,485.1,10.8811320754717,6.73018867924528,5,13,14,21,53
"1211",2017-04-25,63,53,10,4.4,7.97142857142857,0,631.8,10.8238095238095,5.11904761904762,10,7,20,26,63
"1212",2017-04-26,66,56,10,0,12.1227272727273,0,387.9,15.0030303030303,9.24242424242424,7,8,32,19,66
"1213",2017-04-27,44,40,4,8.73181818181818,17.5863636363636,0,18.2,24.8681818181818,10.2977272727273,3,12,13,16,44
"1214",2017-04-28,99,80,19,0,13.7444444444444,0,421.3,17.2222222222222,10.1666666666667,13,14,34,19,80
"1215",2017-04-29,98,76,22,0,10.7775510204082,0,707.8,14.7938775510204,6.93265306122449,29,9,27,33,98
"1216",2017-04-30,70,60,10,17.7014285714286,6.29,0,819.7,8.70857142857143,3.84428571428571,31,17,9,13,70
"1217",2017-05-01,71,65,6,23.1859154929577,9.47323943661972,0,605.4,13.8211267605634,5.02535211267606,16,9,19,27,71
"1218",2017-05-02,58,47,11,0.61551724137931,9.24396551724138,0,507.85,11.3431034482759,7.16896551724138,9,8,23,18,58
"1219",2017-05-03,64,57,7,0,10.56875,0,475.6,15.65,5.425,2,6,34,22,64
"1220",2017-05-04,50,45,5,19.272,8.714,0,464.3,10.988,6.376,4,13,20,13,50
"1221",2017-05-05,63,54,9,29.684126984127,8.31904761904762,0,609.9,9.93174603174603,6.7,3,13,21,26,63
"1222",2017-05-06,57,45,12,0.601754385964912,7.92456140350877,0,574.3,9.88421052631579,5.99298245614035,15,12,13,17,57
"1223",2017-05-07,70,64,6,0,8.72571428571429,0,649.2,12.6485714285714,4.83714285714286,18,11,24,17,70
"1224",2017-05-08,40,27,13,0,7.885,0,404.6,12.635,3.135,6,8,8,18,40
"1225",2017-05-09,44,36,8,0,8.13181818181818,0,434.2,10.9068181818182,5.34545454545455,8,4,20,12,44
"1226",2017-05-10,59,43,16,0,7.74915254237288,0,604.8,10.3677966101695,5.03050847457627,10,8,23,18,59
"1227",2017-05-11,75,59,16,0,10.444,0,566.7,13.604,7.284,9,15,30,21,75
"1228",2017-05-12,64,47,17,0,10.503125,0,479.8,13.4046875,7.5015625,14,6,30,14,64
"1229",2017-05-13,65,48,17,0.649230769230769,12.8169230769231,0,336.9,16.3569230769231,9.26461538461539,21,5,24,15,65
"1230",2017-05-14,77,66,11,0.0831168831168831,12.8272727272727,0,398.3,18.2857142857143,7.35844155844156,23,8,18,28,77
"1231",2017-05-15,64,55,9,0,13.9328125,0,260.3,19.621875,8.14375,6,7,28,23,64
"1232",2017-05-16,52,45,7,0,13.1461538461538,0,252.4,16.1461538461538,10.1769230769231,7,4,17,24,52
"1233",2017-05-17,51,44,7,0,18.9588235294118,1.93921568627451,50,27.6098039215686,10.2549019607843,6,12,14,19,51
"1234",2017-05-18,92,75,17,0,13.0663043478261,0.365217391304348,487.5,16.9130434782609,17.8521739130435,13,7,18,32,70
"1235",2017-05-19,53,44,9,0,14.1037735849057,0,206.5,18.9018867924528,9.30566037735849,7,12,20,14,53
"1236",2017-05-20,84,67,17,0,11.6952380952381,0,529.6,15.0428571428571,8.24761904761905,25,10,18,31,84
"1237",2017-05-21,66,52,14,13.3181818181818,11.5090909090909,0,428.4,13.4030303030303,9.53636363636364,18,7,21,20,66
"1238",2017-05-22,67,59,8,0,11.8701492537313,0,410.7,15.4880597014925,8.43134328358209,12,15,20,20,67
"1239",2017-05-23,70,62,8,0,11.9985714285714,0,420.1,21.2514285714286,8.29714285714286,9,17,19,25,70
"1240",2017-05-24,74,62,12,0,17.3912162162162,0,45.05,21.1743243243243,13.6216216216216,2,9,23,27,61
"1241",2017-05-25,51,41,10,53.1647058823529,12.4117647058824,0,285,14.6725490196078,10.1509803921569,7,6,14,24,51
"1242",2017-05-26,66,54,12,2.85,14.9022727272727,0,204.45,18.7545454545455,11.0772727272727,19,13,22,12,66
"1243",2017-05-27,58,48,10,0,15.7448275862069,0,130.8,18.7827586206897,12.6862068965517,12,6,17,23,58
"1244",2017-05-28,93,72,21,0,15.6268817204301,0,220.7,19.0086021505376,12.1688172043011,11,13,13,32,69
"1245",2017-05-29,76,61,15,0,11.75,0,475,15.3,13.125,11,15,33,17,76
"1246",2017-05-30,51,49,2,9.42156862745098,17.621568627451,0,19.3,22.3294117647059,12.8274509803922,10,9,18,14,51
"1247",2017-05-31,54,45,9,0.816666666666667,17.1,0,48.6,22.9351851851852,11.2648148148148,13,6,16,19,54
"1248",2017-06-01,109,98,11,0,14.7724770642202,0,351.8,18.7669724770642,10.7779816513761,20,9,18,30,77
"1249",2017-06-02,79,62,17,0,15.1088607594937,0,228.4,20.6177215189873,9.6,15,6,30,28,79
"1250",2017-06-03,52,44,8,0,16.9230769230769,0,56,21.9384615384615,11.9076923076923,14,6,21,11,52
"1251",2017-06-04,64,51,13,6.140625,14.28125,0,238,17,11.546875,27,7,16,14,64
"1252",2017-06-05,54,38,16,0,15.6925925925926,0.0555555555555556,127.6,18.4296296296296,13.1407407407407,10,9,17,18,54
"1253",2017-06-06,56,43,13,3.44107142857143,15.1107142857143,0.0482142857142857,164.5,18.3642857142857,12.0178571428571,13,10,13,20,56
"1254",2017-06-07,51,39,12,0,17.3980392156863,0.241176470588235,43,22.0666666666667,13.5333333333333,10,10,14,17,51
"1255",2017-06-08,72,64,8,0,17.7513888888889,0,17.9,23.6416666666667,11.7611111111111,19,10,20,23,72
"1256",2017-06-09,61,52,9,0,20.0606557377049,2.06065573770492,0,25.4540983606557,14.5737704918033,11,12,18,20,61
"1257",2017-06-10,67,54,13,0,21.2582089552239,3.25820895522388,0,26.7044776119403,15.7253731343284,30,9,14,14,67
"1258",2017-06-11,72,68,4,0,23.0875,5.0875,0,27.8444444444444,18.3125,32,2,18,20,72
"1259",2017-06-12,63,50,13,0,24.8428571428571,6.84285714285714,0,30.0714285714286,19.6142857142857,18,11,21,13,63
"1260",2017-06-13,64,48,16,0,22.1109375,4.1109375,0,25.3671875,18.8546875,22,12,11,19,64
"1261",2017-06-14,50,38,12,0,19.59,1.59,0,22.54,16.694,10,7,13,20,50
"1262",2017-06-15,61,50,11,0,17.2672131147541,0,44.7,18.6967213114754,15.7524590163934,13,9,19,20,61
"1263",2017-06-16,74,64,10,2.38783783783784,22.2283783783784,4.22837837837838,0,28.5608108108108,16.0486486486487,14,12,26,22,74
"1264",2017-06-17,79,69,10,0.379746835443038,22.7544303797468,4.75443037974684,0,26.1341772151899,19.2746835443038,18,10,21,30,79
"1265",2017-06-18,83,63,20,1.4,23.7228915662651,5.72289156626506,0,27.5927710843374,19.8385542168675,11,9,16,23,59
"1266",2017-06-19,55,46,9,1.53818181818182,21.6327272727273,3.63272727272727,0,27.3309090909091,16.08,7,14,23,11,55
"1267",2017-06-20,59,44,15,7.38813559322034,18.6322033898305,0.650847457627119,1.1,24.2067796610169,13.0389830508475,9,9,13,28,59
"1268",2017-06-21,49,42,7,0,18.3,0.3,0,23.5714285714286,13.0857142857143,2,5,21,21,49
"1269",2017-06-22,57,46,11,7.59122807017544,17.9070175438597,0.0807017543859649,9.9,21.7649122807018,13.9491228070175,16,12,12,17,57
"1270",2017-06-23,60,47,13,32.8,22.1,4.1,0,25.34,18.76,12,8,17,23,60
"1271",2017-06-24,72,64,8,0,20.325,2.325,0,25.0166666666667,15.6333333333333,15,5,25,27,72
"1272",2017-06-25,73,64,9,2.35616438356164,18.313698630137,0.445205479452055,9.6,21.3,15.2383561643836,30,9,10,24,73
"1273",2017-06-26,47,40,7,3.75106382978723,16.9914893617021,0.0382978723404255,49.2,21.568085106383,12.5425531914894,11,8,16,12,47
"1274",2017-06-27,61,51,10,0.849180327868852,16.4655737704918,0,93.6,20.6688524590164,12.1737704918033,15,9,12,25,61
"1275",2017-06-28,72,59,13,0,18.3,0.3,0,24.1222222222222,12.575,17,16,20,19,72
"1276",2017-06-29,46,35,11,3.46086956521739,19.6869565217391,1.68695652173913,0,25.0130434782609,14.3608695652174,9,10,14,13,46
"1277",2017-06-30,70,45,25,7.98571428571429,22.14,4.14,0,25.9885714285714,18.1914285714286,15,7,17,31,70
"1278",2017-07-01,122,112,10,3.4344262295082,20.6409836065574,2.64098360655738,0,24.4967213114754,16.6852459016393,11,14,20,19,64
"1279",2017-07-02,95,82,13,1.05368421052632,21.2536842105263,3.25368421052632,0,27.8052631578947,14.6831578947368,11,4,18,19,52
"1280",2017-07-03,71,52,19,0,19.7971830985915,1.79718309859155,0,24.3380281690141,15.156338028169,21,10,13,27,71
"1281",2017-07-04,56,44,12,0,20.7785714285714,2.77857142857143,0,25.6714285714286,15.7964285714286,26,10,11,9,56
"1282",2017-07-05,53,44,9,0,20.8735849056604,2.87358490566038,0,25.777358490566,15.9547169811321,8,11,11,23,53
"1283",2017-07-06,59,48,11,0,23.1406779661017,5.14067796610169,0,29.3237288135593,16.9491525423729,9,6,20,24,59
"1284",2017-07-07,84,67,17,6.18809523809524,23.2119047619048,5.21190476190476,0,27.1642857142857,19.2333333333333,13,11,24,19,67
"1285",2017-07-08,71,58,13,0,20.7154929577465,2.71549295774648,0,24.3422535211268,17.0028169014085,30,4,10,27,71
"1286",2017-07-09,66,52,14,0,21.0439393939394,3.04393939393939,0,26.2666666666667,15.8015151515152,22,11,8,25,66
"1287",2017-07-10,69,58,11,0,21.3739130434783,3.37391304347826,0,24.5869565217391,18.1608695652174,13,15,23,18,69
"1288",2017-07-11,58,53,5,0,22.5051724137931,4.5051724137931,0,27.6672413793103,17.3275862068966,17,11,19,11,58
"1289",2017-07-12,62,55,7,0,22.7112903225806,4.71129032258065,0,26.141935483871,19.2516129032258,6,2,20,34,62
"1290",2017-07-13,51,39,12,10.9647058823529,17.6823529411765,0,16.2,19.4882352941176,15.8529411764706,10,10,9,22,51
"1291",2017-07-14,64,55,9,0.165625,21.765625,3.765625,0,26.2140625,17.2,7,10,19,28,64
"1292",2017-07-15,87,80,7,0,22.7413793103448,4.74137931034483,0,27.0885057471264,18.2942528735632,20,12,27,28,87
"1293",2017-07-16,83,70,13,0,21.7542168674699,3.75421686746988,0,25.6903614457831,17.7975903614458,25,11,28,19,83
"1294",2017-07-17,61,57,4,0,22.3016393442623,4.30163934426229,0,24.6295081967213,19.8918032786885,13,8,12,28,61
"1295",2017-07-18,63,53,10,0,22.2904761904762,4.29047619047619,0,26.7047619047619,17.8761904761905,12,9,16,26,63
"1296",2017-07-19,48,44,4,0,25.25,7.25,0,30.975,19.525,11,9,11,17,48
"1297",2017-07-20,65,54,11,26.5661538461538,19.1861538461538,1.18615384615385,0,22.9169230769231,15.4553846153846,12,7,17,29,65
"1298",2017-07-21,60,45,15,0,24.4166666666667,6.41666666666667,0,29.7333333333333,19.0083333333333,17,8,17,18,60
"1299",2017-07-22,76,66,10,1.40921052631579,22.0144736842105,4.01447368421053,0,24.6394736842105,19.3552631578947,26,4,22,24,76
"1300",2017-07-23,92,76,16,0,22.0184782608696,4.01847826086957,0,24.1260869565217,19.7945652173913,27,9,12,19,67
"1301",2017-07-24,79,59,20,0,19.9645569620253,1.96455696202532,0,23.0455696202532,16.8556962025316,14,10,23,32,79
"1302",2017-07-25,57,35,22,0.16140350877193,19.7035087719298,1.70350877192982,0,22.8684210526316,16.4578947368421,13,12,11,21,57
"1303",2017-07-26,74,63,11,1.19189189189189,19.1310810810811,1.13108108108108,0,22.4797297297297,15.6675675675676,12,16,27,19,74
"1304",2017-07-27,75,61,14,6.2,22.6933333333333,4.69333333333333,0,26.54,18.7533333333333,11,11,21,32,75
"1305",2017-07-28,53,48,5,0,20.1660377358491,2.16603773584906,0,23.3603773584906,16.8849056603774,16,5,15,17,53
"1306",2017-07-29,94,77,17,0,21.8436170212766,3.8436170212766,0,26.831914893617,16.7553191489362,22,16,18,19,75
"1307",2017-07-30,91,83,8,0,25.2571428571429,7.25714285714286,0,30.5285714285714,19.9714285714286,32,13,17,29,91
"1308",2017-07-31,66,53,13,0.0606060606060606,23.5621212121212,5.56212121212121,0,28.6636363636364,18.4530303030303,14,11,15,26,66
"1309",2017-08-01,79,65,14,0.616455696202532,24.2658227848101,6.26582278481013,0,28.7974683544304,19.7227848101266,26,12,21,20,79
"1310",2017-08-02,58,53,5,1.31896551724138,24.3672413793103,6.36724137931034,0,29.3344827586207,19.3879310344828,12,11,13,22,58
"1311",2017-08-03,59,51,8,0,23.7152542372881,5.71525423728814,0,27.8457627118644,19.5677966101695,9,12,18,20,59
"1312",2017-08-04,75,62,13,8.62,21.8,3.8,0,26.2933333333333,17.2933333333333,7,10,28,30,75
"1313",2017-08-05,71,58,13,0.667605633802817,18.2478873239437,0.332394366197183,6,21.9845070422535,14.4943661971831,16,8,16,31,71
"1314",2017-08-06,72,57,15,0,18.5333333333333,0.583333333333333,3.6,24.0833333333333,12.8833333333333,11,6,8,24,49
"1315",2017-08-07,58,47,11,0.120689655172414,18.2551724137931,0.351724137931035,5.6,21.1431034482759,15.2672413793103,13,8,10,27,58
"1316",2017-08-08,42,35,7,0.171428571428571,19.9428571428571,1.94285714285714,0,25.0428571428571,14.7428571428571,9,4,14,15,42
"1317",2017-08-09,53,47,6,0,22.1301886792453,4.13018867924528,0,27.4245283018868,16.822641509434,3,10,19,21,53
"1318",2017-08-10,54,46,8,0,21.7555555555556,3.75555555555556,0,26.4259259259259,17.0037037037037,10,13,17,14,54
"1319",2017-08-11,64,54,10,0.1953125,20.9453125,2.9453125,0,24.4296875,17.3609375,11,12,22,19,64
"1320",2017-08-12,62,53,9,0,21.4193548387097,3.41935483870968,0,26.1548387096774,16.5838709677419,19,4,16,23,62
"1321",2017-08-13,79,59,20,0,20.4987341772152,2.49873417721519,0,25.7696202531646,15.1278481012658,11,8,13,24,56
"1322",2017-08-14,79,67,12,0,21.4430379746835,3.44303797468354,0,25.6708860759494,17.1911392405063,12,10,19,19,60
"1323",2017-08-15,55,50,5,0,21.14,3.14,0,25.5672727272727,16.6709090909091,13,10,15,17,55
"1324",2017-08-16,77,62,15,0,20.4376623376623,2.43766233766234,0,23.0909090909091,17.7844155844156,10,16,13,19,58
"1325",2017-08-17,50,37,13,8.28,20.616,2.616,0,23.304,17.912,11,6,21,12,50
"1326",2017-08-18,49,43,6,0,24.1285714285714,6.12857142857143,0,27.6285714285714,20.6142857142857,9,7,7,26,49
"1327",2017-08-19,82,66,16,0,21.1451219512195,3.14512195121951,0,25.1280487804878,17.1414634146341,30,14,18,20,82
"1328",2017-08-20,70,57,13,0,21.9428571428571,3.94285714285714,0,27.5428571428571,16.2571428571429,19,8,17,26,70
"1329",2017-08-21,63,51,12,0,23.3571428571429,5.35714285714286,0,28.2047619047619,18.4904761904762,6,10,19,28,63
"1330",2017-08-22,70,52,18,0.765714285714286,21.2714285714286,3.27142857142857,0,26.3542857142857,16.1114285714286,15,12,26,17,70
"1331",2017-08-23,65,53,12,0,19.1492307692308,1.16,0.7,24.1,14.0984615384615,12,8,14,31,65
"1332",2017-08-24,57,49,8,0,16.719298245614,0,73,20.7543859649123,12.6666666666667,10,12,19,16,57
"1333",2017-08-25,60,55,5,0,16.69,0,78.6,21.22,12.06,14,10,12,24,60
"1334",2017-08-26,67,61,6,0,16.7746268656716,0,82.1,21.7910447761194,11.6791044776119,24,9,18,16,67
"1335",2017-08-27,60,53,7,0,17.3666666666667,0,38,21.3833333333333,13.2666666666667,24,10,14,12,60
"1336",2017-08-28,51,44,7,0,20.121568627451,2.12156862745098,0,22.9980392156863,17.1450980392157,2,6,18,25,51
"1337",2017-08-29,53,46,7,0,19.2811320754717,1.2811320754717,0,21.6433962264151,16.9188679245283,10,4,15,24,53
"1338",2017-08-30,42,38,4,0,18.9785714285714,1.02142857142857,1.8,23.0785714285714,14.8,7,8,10,17,42
"1339",2017-08-31,58,45,13,0.655172413793103,15.848275862069,0,124.8,20.1,11.5034482758621,14,9,17,18,58
"1340",2017-09-01,114,104,10,0,13.8087719298246,0,477.8,17.9947368421053,9.52280701754386,11,9,25,27,72
"1341",2017-09-02,57,48,9,0,14.8,0,182.4,19.2122807017544,10.3877192982456,20,9,10,18,57
"1342",2017-09-03,75,61,14,7.33733333333333,18.3213333333333,0.321333333333333,0,21.7786666666667,14.8426666666667,17,6,19,33,75
"1343",2017-09-04,59,48,11,3.95254237288136,20.1016949152542,2.10169491525424,0,25.3898305084746,14.8,17,13,18,11,59
"1344",2017-09-05,65,55,10,7.66153846153846,17.3384615384615,0,43,20.7769230769231,13.8,11,13,19,22,65
"1345",2017-09-06,56,45,11,0,16.6464285714286,0,75.8,20.8928571428571,12.3892857142857,6,9,26,15,56
"1346",2017-09-07,46,39,7,5.23260869565217,15.354347826087,0,121.7,19.0326086956522,11.5869565217391,2,14,14,16,46
"1347",2017-09-08,58,49,9,0,15.0344827586207,0,172,18.8086206896552,11.1603448275862,12,10,15,21,58
"1348",2017-09-09,55,45,10,0,13.6272727272727,0,240.5,18.2636363636364,8.90909090909091,15,7,11,22,55
"1349",2017-09-10,73,63,10,0,14.7356164383562,0,238.3,18.9520547945205,10.5191780821918,21,11,21,20,73
"1350",2017-09-11,47,43,4,0,16.0702127659574,0,90.7,21.9808510638298,10.0595744680851,8,5,14,20,47
"1351",2017-09-12,50,49,1,0,17.772,0,11.4,23.016,12.442,5,11,22,12,50
"1352",2017-09-13,61,53,8,0,18.8786885245902,1.06229508196721,11.2,24.0754098360656,13.5934426229508,10,10,25,16,61
"1353",2017-09-14,65,53,12,0,21.2615384615385,3.26153846153846,0,26.0369230769231,16.4861538461538,14,7,22,22,65
"1354",2017-09-15,77,63,14,0,21.5727272727273,3.57272727272727,0,25.2272727272727,17.8272727272727,16,18,22,21,77
"1355",2017-09-16,94,79,15,0,21.1851063829787,3.18510638297872,0,25.7468085106383,16.7191489361702,21,16,20,19,76
"1356",2017-09-17,66,57,9,0,21.6128787878788,3.61287878787879,0,26.2704545454545,16.9454545454545,22,9,14,21,66
"1357",2017-09-18,75,48,27,0,22.3546666666667,4.35466666666667,0,26.5306666666667,18.1786666666667,11,15,19,30,75
"1358",2017-09-19,71,51,20,0,22.8676056338028,4.86760563380282,0,25.6746478873239,19.9760563380282,22,4,24,21,71
"1359",2017-09-20,58,50,8,0,21.8379310344828,3.83793103448276,0,24.4137931034483,19.1620689655172,6,9,15,16,46
"1360",2017-09-21,64,56,8,0,22.215625,4.215625,0,26.603125,17.81875,7,18,29,10,64
"1361",2017-09-22,70,60,10,0,22.1971428571429,4.19714285714286,0,25.9114285714286,18.3828571428571,13,10,22,25,70
"1362",2017-09-23,64,51,13,0,24.1,6.1,0,30.01875,18.18125,12,11,16,25,64
"1363",2017-09-24,59,48,11,0,26.0152542372881,8.01525423728814,0,30.8847457627119,21.0457627118644,13,12,13,21,59
"1364",2017-09-25,57,48,9,0,25.7868421052632,7.78684210526316,0,31.0342105263158,20.7736842105263,6,8,24,19,57
"1365",2017-09-26,58,45,13,0,24.6551724137931,6.6551724137931,0,29.351724137931,21.3551724137931,10,7,19,22,58
"1366",2017-09-27,59,54,5,0,21.6779661016949,3.67796610169492,0,28.6576271186441,14.8,11,12,19,17,59
"1367",2017-09-28,67,55,12,0,15.1179104477612,0.0313432835820895,195.2,19.3268656716418,10.8850746268657,9,12,27,19,67
"1368",2017-09-29,46,37,9,2.44565217391304,13.9065217391304,0,188.3,18.2521739130435,9.54565217391304,7,5,15,19,46
"1369",2017-09-30,71,59,12,0,12.5091549295775,0.0640845070422535,394.4,16.7274647887324,8.42816901408451,20,10,11,30,71
"1370",2017-10-01,94,87,7,0,11.613829787234,0,600.3,16.9723404255319,6.15531914893617,11,16,20,20,67
"1371",2017-10-02,67,53,14,0,14.1611940298507,0,257.2,18.5462686567164,9.77611940298507,6,12,27,22,67
"1372",2017-10-03,70,56,14,0,17.4857142857143,0,36,23.3714285714286,11.6,3,12,30,25,70
"1373",2017-10-04,63,54,9,3.56031746031746,18.9126984126984,0.912698412698413,0,24.3380952380952,13.4047619047619,9,18,14,22,63
"1374",2017-10-05,48,32,16,0,16.64375,0,65.1,22.40625,10.875,4,11,17,16,48
"1375",2017-10-06,59,42,17,0.432203389830508,17.0271186440678,0,57.4,19.6050847457627,14.4491525423729,9,12,24,14,59
"1376",2017-10-07,72,59,13,4.725,20.95,2.95,0,24.4,17.4,26,9,14,23,72
"1377",2017-10-08,65,60,5,0,20.2676923076923,2.63076923076923,23.6,23.78,16.4769230769231,18,7,27,13,65
"1378",2017-10-09,45,34,11,13.0866666666667,18.0222222222222,0.164444444444444,6.4,21.3266666666667,14.6177777777778,7,6,14,18,45
"1379",2017-10-10,56,48,8,0,18.1035714285714,0.167857142857143,3.6,23.4107142857143,12.7803571428571,4,12,30,10,56
"1380",2017-10-11,68,58,10,1.03235294117647,11.1441176470588,0,466.2,14.2735294117647,8.01470588235294,7,6,23,32,68
"1381",2017-10-12,39,32,7,0,12.3307692307692,0,221.1,15.4153846153846,9.14615384615385,4,6,16,13,39
"1382",2017-10-13,57,43,14,0,16.8,0,68.4,18.7877192982456,14.7122807017544,14,8,27,8,57
"1383",2017-10-14,73,66,7,7.38493150684932,16.5397260273973,0,106.6,18.8095890410959,14.1698630136986,20,3,33,17,73
"1384",2017-10-15,54,45,9,4.78333333333333,15.8666666666667,0,115.2,23.4166666666667,8.23333333333333,21,4,14,15,54
"1385",2017-10-16,67,56,11,0,7.4,0,710.2,9.94179104477612,4.85223880597015,12,9,17,29,67
"1386",2017-10-17,60,50,10,0,11.7416666666667,0,375.5,18.9416666666667,4.45,4,19,23,14,60
"1387",2017-10-18,64,52,12,0,15.3921875,0,166.9,20.7671875,10.0171875,9,11,24,20,64
"1388",2017-10-19,65,52,13,0,15.7830769230769,0,144.1,20.9,10.6523076923077,7,13,30,15,65
"1389",2017-10-20,87,62,25,0,14.151724137931,0,334.8,19.3390804597701,8.86436781609195,20,13,12,19,64
"1390",2017-10-21,63,52,11,0,15.5222222222222,0,156.1,20.5111111111111,10.4333333333333,25,4,16,18,63
"1391",2017-10-22,56,42,14,0,16.8446428571429,0,64.7,21.9571428571429,11.6321428571429,23,5,13,15,56
"1392",2017-10-23,63,55,8,8.76666666666667,17.0666666666667,0,58.8,19.1555555555556,14.8888888888889,13,9,29,12,63
"1393",2017-10-24,72,62,10,0.893055555555556,13.3930555555556,0,331.7,16.5930555555556,10.1930555555556,4,8,18,23,53
"1394",2017-10-25,68,59,9,0,8.8,0,625.6,11.8529411764706,5.64705882352941,10,18,20,20,68
"1395",2017-10-26,46,37,9,0,7.65652173913043,0,475.8,11.4086956521739,3.81304347826087,8,5,11,22,46
"1396",2017-10-27,69,55,14,0,9.83913043478261,0,563.1,14.4797101449275,5.09855072463768,15,4,26,24,69
"1397",2017-10-28,54,40,14,5.87037037037037,9.15555555555556,0,477.6,13.3703703703704,4.85555555555556,20,10,7,17,54
"1398",2017-10-29,72,63,9,0,6.91388888888889,0,798.2,8.81388888888889,4.92777777777778,22,11,22,17,72
"1399",2017-10-30,52,45,7,0,13.675,0,224.9,16.9480769230769,5.91923076923077,7,10,19,16,52
"1400",2017-10-31,87,50,37,0,6.82068965517241,0,972.6,8.54137931034483,5,9,15,23,19,66
"1401",2017-11-01,107,103,4,0.979439252336449,6.23644859813084,0,1258.7,7.60467289719626,4.78411214953271,11,12,33,28,84
"1402",2017-11-02,52,40,12,8.62115384615385,10.6480769230769,0,382.3,14.5961538461538,6.7,8,9,19,16,52
"1403",2017-11-03,61,45,16,1.40327868852459,8.19672131147541,0,598,11.8131147540984,4.58032786885246,6,10,16,29,61
"1404",2017-11-04,70,58,12,0.371428571428571,5.68571428571429,0,862,7.60714285714286,3.6,19,7,12,32,70
"1405",2017-11-05,74,62,12,15.3081081081081,11.3405405405405,0,492.8,14.9864864864865,7.59459459459459,27,8,15,24,74
"1406",2017-11-06,55,47,8,0,8.81818181818182,0,505,12.7363636363636,4.9,7,10,22,16,55
"1407",2017-11-07,55,41,14,0,5.47090909090909,0,689.1,7.62,3.96363636363636,5,8,20,22,55
"1408",2017-11-08,72,49,23,0,5.02083333333333,0,934.5,8.85,1.05416666666667,18,9,23,22,72
"1409",2017-11-09,64,54,10,0,2.9625,0,962.4,8.7875,-2.95625,8,13,28,15,64
"1410",2017-11-10,74,50,24,0.194594594594595,-6.07837837837838,0,1781.8,-3.1972972972973,-8.98648648648649,2,17,18,19,56
"1411",2017-11-11,77,73,4,0,-1.8,0,1524.6,2.6,-6.2,24,17,15,21,77
"1412",2017-11-12,87,77,10,1.43793103448276,4.16206896551724,0,1203.9,5.88735632183908,2.42413793103448,24,14,25,24,87
"1413",2017-11-13,81,68,13,0.27037037037037,4.41851851851852,0,1100.1,6.25802469135802,2.48024691358025,11,12,20,19,62
"1414",2017-11-14,62,48,14,0,5.48387096774194,0,776,6.94193548387097,3.9258064516129,12,11,27,12,62
"1415",2017-11-15,67,61,6,2.66567164179104,5.94029850746269,0,808,8.04029850746269,3.84029850746269,5,9,25,17,56
"1416",2017-11-16,49,38,11,0.287755102040816,4.2530612244898,0,673.6,8.27551020408163,0.189795918367347,7,9,14,19,49
"1417",2017-11-17,60,42,18,0,1.90666666666667,0,965.6,4.67833333333333,-1.13,7,11,17,25,60
"1418",2017-11-18,83,65,18,17.8626506024096,5.61566265060241,0,1027.9,8.31566265060241,2.81566265060241,28,18,18,19,83
"1419",2017-11-19,80,69,11,0.645,1.93375,0,1285.3,4.8675,-1,30,8,19,23,80
"1420",2017-11-20,48,43,5,0,3.21041666666667,0,709.9,6.58958333333333,-0.16875,4,14,16,14,48
"1421",2017-11-21,59,51,8,0,7.64745762711864,0,610.8,11.5949152542373,3.6,13,5,13,28,59
"1422",2017-11-22,59,44,15,0,1.17627118644068,0,992.6,3.9,-1.55932203389831,10,11,26,12,59
"1423",2017-11-23,55,49,6,0,1.94727272727273,0,882.9,4.14727272727273,-0.276363636363636,5,10,26,14,55
"1424",2017-11-24,89,74,15,0,6.0123595505618,0,1066.9,9.5808988764045,2.3438202247191,20,11,33,25,89
"1425",2017-11-25,65,57,8,0.590769230769231,6.23846153846154,0,764.5,9.98923076923077,2.15230769230769,22,9,17,17,65
"1426",2017-11-26,59,53,6,0,2.95084745762712,0,887.9,4.99152542372881,0.627118644067797,17,6,16,20,59
"1427",2017-11-27,55,44,11,0,5.21636363636364,0,703.1,7.41636363636364,1.23454545454545,3,15,22,15,55
"1428",2017-11-28,72,63,9,0,8.34583333333333,0,695.1,14.8013888888889,1.87222222222222,6,17,19,30,72
"1429",2017-11-29,89,69,20,0,6.59213483146067,0,1015.3,11.5865168539326,1.51123595505618,21,11,27,30,89
"1430",2017-11-30,50,38,12,2.008,4.746,0,662.7,7.182,2.21,1,11,15,23,50
"1431",2017-12-01,87,75,12,0,5.59080459770115,0,1079.6,7.8,3.2816091954023,19,16,23,29,87
"1432",2017-12-02,72,60,12,0,4.8,0,950.4,7.725,1.875,30,6,16,20,72
"1433",2017-12-03,65,58,7,0,4.76923076923077,0,860,7.68461538461538,1.84615384615385,13,2,24,26,65
"1434",2017-12-04,69,58,11,2.39275362318841,6.74057971014493,0,776.9,10.6840579710145,2.79710144927536,7,10,24,28,69
"1435",2017-12-05,43,35,8,5.61860465116279,5.68139534883721,0,529.7,10.6488372093023,0.618604651162791,4,7,20,12,43
"1436",2017-12-06,51,49,2,0,1.15882352941176,0,858.9,3.47843137254902,-1.25098039215686,5,7,24,15,51
"1437",2017-12-07,61,50,11,0,-0.591803278688525,0,1134.1,1.09180327868852,-2.18360655737705,11,10,20,20,61
"1438",2017-12-08,43,35,8,0,-0.762790697674419,0,806.8,1.24651162790698,-2.67209302325581,7,4,17,15,43
"1439",2017-12-09,62,46,16,0,0.108064516129032,0,1109.3,1.90806451612903,-1.7,15,6,25,16,62
"1440",2017-12-10,55,50,5,0,-1.83636363636364,0,1091,-0.601818181818182,-3.00363636363636,17,7,13,18,55
"1441",2017-12-11,71,59,12,2.98028169014085,-4.06478873239437,0,1566.6,-1.48591549295775,-6.63661971830986,13,13,30,15,71
"1442",2017-12-12,54,46,8,3.29259259259259,-6.31851851851852,0,1313.2,-1.27777777777778,-11.3388888888889,6,9,22,17,54
"1443",2017-12-13,66,52,14,0.145454545454545,-8.05909090909091,0,1719.9,-5.05909090909091,-10.9590909090909,7,14,24,21,66
"1444",2017-12-14,46,41,5,0.165217391304348,-9.86521739130435,0,1281.8,-5.56521739130435,-14.0826086956522,6,5,10,25,46
"1445",2017-12-15,90,69,21,0.416666666666667,-6.26666666666667,0,2184,-2.93333333333333,-9.6,18,11,34,27,90
"1446",2017-12-16,51,39,12,0,-5.51176470588235,0,1199.1,-3.03725490196078,-7.91764705882353,14,6,13,18,51
"1447",2017-12-17,89,65,24,0.157303370786517,-8.12247191011236,0,2324.9,-4.95168539325843,-11.214606741573,31,9,22,27,89
"1448",2017-12-18,77,59,18,2.50649350649351,-0.6,0,1432.2,4.58571428571429,-5.77532467532468,9,15,29,24,77
"1449",2017-12-19,46,40,6,0,4.83695652173913,0,605.5,7.03695652173913,2.54565217391304,4,8,14,20,46
"1450",2017-12-20,62,56,6,0,0.132258064516129,0,1107.8,3.14838709677419,-2.89193548387097,1,9,21,20,51
"1451",2017-12-21,45,41,4,1.86,-3.25333333333333,0,956.4,-1.53555555555556,-4.87111111111111,4,10,16,15,45
"1452",2017-12-22,57,54,3,3.04210526315789,-3.73157894736842,0,1238.7,-1.71052631578947,-5.65263157894737,11,13,20,13,57
"1453",2017-12-23,70,61,9,3.07857142857143,-2.07857142857143,0,1405.5,0.614285714285714,-4.77142857142857,25,8,11,26,70
"1454",2017-12-24,53,51,2,6.71698113207547,-2.9622641509434,0,1111,-1.04716981132075,-4.77735849056604,18,3,16,16,53
"1455",2017-12-25,43,43,0,0.97906976744186,-6.77209302325581,0,1065.2,-2.99302325581395,-10.4581395348837,16,5,7,15,43
"1456",2017-12-26,33,28,5,0,-12.2545454545455,0,998.4,-10.1636363636364,-14.3454545454545,5,4,9,15,33
"1457",2017-12-27,60,49,11,0,-13.85,0,1911,-9.86666666666667,-17.8166666666667,13,5,26,16,60
"1458",2017-12-28,45,39,6,0.182222222222222,-15.6555555555556,0,1514.5,-11.7555555555556,-19.5466666666667,8,10,6,21,45
"1459",2017-12-29,57,49,8,0.859649122807018,-10.7157894736842,0,1636.8,-7.24385964912281,-14.1736842105263,7,7,13,30,57
"1460",2017-12-30,61,55,6,0.167213114754098,-12.4508196721311,0,1857.5,-6.78360655737705,-18.0344262295082,20,8,18,15,61
"1461",2017-12-31,52,41,11,0,-16.9192307692308,0,1815.8,-13.6326923076923,-20.1192307692308,13,5,12,22,52
"1462",2018-01-01,177,169,8,0.16271186440678,-13.2627118644068,0,5533.5,-7.88135593220339,-18.5440677966102,11,9,28,20,68
"1463",2018-01-02,50,38,12,0,-9.728,0,1386.4,-7.016,-12.428,10,10,17,13,50
"1464",2018-01-03,43,36,7,0.172093023255814,-8.20232558139535,0,1126.7,-5.24418604651163,-11.0744186046512,12,6,7,18,43
"1465",2018-01-04,47,32,15,0.174468085106383,-13.6617021276596,0,1488.1,-7.66170212765957,-19.6617021276596,12,5,19,11,47
"1466",2018-01-05,64,58,6,0,-17.721875,0,2286.2,-14.721875,-20.621875,13,12,12,27,64
"1467",2018-01-06,56,52,4,0,-18.8785714285714,0,2065.2,-15.4,-22.2678571428571,13,8,14,21,56
"1468",2018-01-07,60,46,14,0,-9.26666666666667,0,1636,-0.966666666666667,-17.4733333333333,19,4,20,17,60
"1469",2018-01-08,78,58,20,4.73717948717949,0.714102564102564,0,1348.3,2.97179487179487,-1.62948717948718,13,15,28,22,78
"1470",2018-01-09,56,50,6,0,0.471428571428571,0,981.6,1.59285714285714,-0.65,5,11,23,17,56
"1471",2018-01-10,61,51,10,0.873770491803279,2.11639344262295,0,968.9,5.54590163934426,-1.32622950819672,10,6,32,13,61
"1472",2018-01-11,54,47,7,9.51666666666667,8.05,0,537.3,11.2740740740741,4.82592592592593,9,9,24,12,54
"1473",2018-01-12,52,44,8,16.2923076923077,0.261538461538462,0,922.4,11.5884615384615,-11.1480769230769,10,9,17,16,52
"1474",2018-01-13,67,62,5,0.161194029850746,-12.7417910447761,0,2059.7,-10.9611940298507,-14.4223880597015,11,11,15,30,67
"1475",2018-01-14,53,44,9,0,-9.81509433962264,0,1474.2,-5.38490566037736,-14.2452830188679,20,6,16,11,53
"1476",2018-01-15,53,42,11,2.67169811320755,-6.5622641509434,0,1301.8,-5.02452830188679,-8.1,6,16,14,17,53
"1477",2018-01-16,75,62,13,1.028,-5.6,0,1770,-2.416,-8.692,9,11,28,27,75
"1478",2018-01-17,46,33,13,0,-7.79565217391304,0,1186.6,-4.60217391304348,-10.9869565217391,13,4,12,17,46
"1479",2018-01-18,67,56,11,0,-5.22537313432836,0,1556.1,-2.94029850746269,-7.41044776119403,6,12,28,21,67
"1480",2018-01-19,81,61,20,0,-0.425925925925926,0,1492.5,3.05061728395062,-3.80246913580247,9,9,24,28,70
"1481",2018-01-20,60,51,9,0,3.76666666666667,0,854,6.60833333333333,0.825,10,9,25,16,60
"1482",2018-01-21,75,62,13,0.24,1.9,0,1207.5,3.96,-0.24,20,2,22,31,75
"1483",2018-01-22,51,43,8,11.9411764705882,1.92941176470588,0,819.6,2.89411764705882,0.882352941176471,12,7,21,11,51
"1484",2018-01-23,64,47,17,1.6625,2.0625,0,1020,8.01875,-3.9875,10,6,30,18,64
"1485",2018-01-24,50,40,10,0.18,-7.17,0,1258.5,-3.89,-10.36,10,6,16,18,50
"1486",2018-01-25,57,46,11,0,-5.40701754385965,0,1334.2,-0.8,-10.0070175438596,11,8,19,19,57
"1487",2018-01-26,48,36,12,0,2.78333333333333,0,730.4,6.59166666666667,-1.03333333333333,11,8,13,16,48
"1488",2018-01-27,71,53,18,0.673239436619718,5.71549295774648,0,872.2,8.76056338028169,2.5887323943662,20,11,19,21,71
"1489",2018-01-28,58,48,10,0,2.06551724137931,0,924.2,5.41379310344828,-1.36551724137931,15,8,15,20,58
"1490",2018-01-29,46,44,2,5.40869565217391,-3.68913043478261,0,997.7,-1.08913043478261,-6.27826086956522,5,8,17,16,46
"1491",2018-01-30,57,49,8,0.301754385964912,-9.15087719298246,0,1547.6,-6.15087719298246,-12.1263157894737,8,17,16,16,57
"1492",2018-01-31,64,54,10,1.3828125,-4.7078125,0,1453.3,2.9609375,-12.284375,10,17,20,17,64
"1493",2018-02-01,71,62,9,0,-1.75633802816901,0,1402.7,5.48732394366197,-8.9,25,10,16,20,71
"1494",2018-02-02,54,43,11,0.181481481481481,-11.7351851851852,0,1605.7,-8.51666666666667,-14.9444444444444,9,9,19,17,54
"1495",2018-02-03,64,58,6,0.890625,-4.634375,0,1448.6,0.4328125,-9.6125,25,8,8,23,64
"1496",2018-02-04,53,36,17,4.00188679245283,-3.5,0,1139.5,1.70377358490566,-8.70377358490566,22,4,11,16,53
"1497",2018-02-05,58,43,15,0,-9.24827586206897,0,1580.4,-6.49655172413793,-12,12,7,18,21,58
"1498",2018-02-06,59,53,6,0.16271186440678,-5.71864406779661,0,1399.4,-3.25593220338983,-8.18135593220339,5,7,32,15,59
"1499",2018-02-07,37,28,9,7.22972972972973,-6.36756756756757,0,901.6,-4.1,-8.63513513513514,4,6,12,15,37
"1500",2018-02-08,46,38,8,0,-7.5,0,1173,-5.26521739130435,-9.64565217391304,6,5,20,15,46
"1501",2018-02-09,64,51,13,4.484375,-6.034375,0,1538.2,-3.425,-8.64375,9,16,18,21,64
"1502",2018-02-10,59,48,11,5.64576271186441,-4.04067796610169,0,1300.4,-2.98813559322034,-5.00508474576271,11,8,17,23,59
"1503",2018-02-11,55,42,13,2.9,-2.81272727272727,0,1144.7,-0.534545454545455,-5.06909090909091,25,7,6,17,55
"1504",2018-02-12,56,51,5,0.251785714285714,-5.1,0,1293.6,-1.81607142857143,-8.36785714285714,5,15,16,20,56
"1505",2018-02-13,37,32,5,0,-5.45945945945946,0,868,-0.843243243243243,-10.0756756756757,5,7,10,15,37
"1506",2018-02-14,65,54,11,0,2.21692307692308,0,1025.9,5.43076923076923,-1.08615384615385,12,12,19,22,65
"1507",2018-02-15,56,49,7,0,6.18571428571429,0,661.6,9.32857142857143,2.95714285714286,9,15,13,19,56
"1508",2018-02-16,57,46,11,0,-0.0210526315789474,0,1027.2,4.86315789473684,-4.90526315789474,11,9,14,23,57
"1509",2018-02-17,64,49,15,0,-2.85,0,1334.4,-0.375,-5.325,18,14,15,17,64
"1510",2018-02-18,62,53,9,0,1.54354838709677,0,1020.3,4.3758064516129,-1.3,19,8,19,16,62
"1511",2018-02-19,50,41,9,13.498,3.02,0,749,5.638,0.384,11,9,15,15,50
"1512",2018-02-20,54,43,11,7.57407407407407,10.05,0,429.3,15.0074074074074,4.99259259259259,7,2,24,21,54
"1513",2018-02-21,76,57,19,6.55263157894737,6.56973684210526,0,868.7,14.3039473684211,-1.16447368421053,14,16,28,18,76
"1514",2018-02-22,68,58,10,0.185294117647059,-0.385294117647059,0,1250.2,1.21470588235294,-1.88529411764706,8,13,24,23,68
"1515",2018-02-23,63,54,9,2.57777777777778,3.3,0,926.1,6.87777777777778,-0.288888888888889,10,7,21,25,63
"1516",2018-02-24,65,54,11,0,3.99846153846154,0,910.1,6.18307692307692,1.79692307692308,16,11,17,21,65
"1517",2018-02-25,67,61,6,4.27014925373134,6.62238805970149,0,762.3,11.844776119403,1.37014925373134,21,11,20,15,67
"1518",2018-02-26,48,39,9,0,4.475,0,649.2,8.26666666666667,0.675,9,7,17,15,48
"1519",2018-02-27,53,44,9,0,6.96603773584906,0,584.8,13.0754716981132,0.764150943396226,5,9,19,20,53
"1520",2018-02-28,63,53,10,0,-1.02539682539683,0,1198.6,2.73650793650794,4.69523809523809,7,17,21,18,63
"1521",2018-03-01,123,109,14,0.494308943089431,1.28211382113821,0,2056.3,4.7,-2.32276422764228,11,15,18,28,72
"1522",2018-03-02,69,47,22,0.142028985507246,1.14057971014493,0,1163.3,4.37536231884058,-0.5,2,12,25,30,69
"1523",2018-03-03,55,42,13,0,1.11272727272727,0,928.8,4.71272727272727,-2.66181818181818,17,3,18,17,55
"1524",2018-03-04,53,43,10,0,0.871698113207547,0,907.8,4.32641509433962,-3.05849056603774,14,8,20,11,53
"1525",2018-03-05,57,47,10,0,0.678947368421053,0,987.3,4.23684210526316,-3.03684210526316,8,7,29,13,57
"1526",2018-03-06,60,55,5,0,1.06,0,1016.4,4.35333333333333,-1.28,5,12,30,13,60
"1527",2018-03-07,44,40,4,0,1.75454545454545,0,714.8,3.05454545454545,0.354545454545455,3,9,16,16,44
"1528",2018-03-08,70,49,21,0,-1.00571428571429,0,1330.4,0.488571428571429,-2.5,12,5,26,27,70
"1529",2018-03-09,58,49,9,0,1.82068965517241,0,938.4,5.34137931034483,-1.8,8,6,16,28,58
"1530",2018-03-10,64,47,17,0.184375,0.5921875,0,1114.1,3.2078125,-2.1234375,19,6,21,18,64
"1531",2018-03-11,72,52,20,0,0.363888888888889,0,1269.8,3.99583333333333,-3.36805555555556,23,10,16,23,72
"1532",2018-03-12,67,56,11,0.447761194029851,-1.26865671641791,0,1291,-0.0164179104477612,-2.51044776119403,17,7,8,35,67
"1533",2018-03-13,71,56,15,0.309859154929577,-0.00985915492957747,0,1278.7,2.75774647887324,-2.7,10,8,15,19,52
"1534",2018-03-14,62,47,15,0.193548387096774,-0.303225806451613,0,1134.8,2.19677419354839,-2.70322580645161,12,12,14,24,62
"1535",2018-03-15,52,42,10,0.180769230769231,1.35192307692308,0,865.7,6.31346153846154,-3.70961538461538,12,7,18,15,52
"1536",2018-03-16,76,56,20,0,-3.12105263157895,0,1605.2,0.405263157894737,-6.64736842105263,17,7,22,30,76
"1537",2018-03-17,75,66,9,0,1.152,0,1263.6,6.46933333333333,-4.248,18,9,20,28,75
"1538",2018-03-18,93,83,10,0,1.31397849462366,0,1551.8,6.31397849462366,-3.76881720430108,32,17,25,19,93
"1539",2018-03-19,45,34,11,0,-3.3,0,958.5,-0.24,-6.28,9,7,16,13,45
"1540",2018-03-20,52,45,7,0,-1.73846153846154,0,1026.4,1.44230769230769,-4.82884615384615,6,11,18,17,52
"1541",2018-03-21,65,58,7,0,1.34307692307692,0,1082.7,6.24307692307692,-3.65692307692308,7,9,20,16,52
"1542",2018-03-22,40,38,2,0,1.24,0,670.4,5.44,-3.06,2,7,16,15,40
"1543",2018-03-23,51,35,16,0,1.0156862745098,0,866.2,4.99411764705882,-3.04705882352941,9,14,16,12,51
"1544",2018-03-24,44,35,9,0,-0.563636363636364,0,816.8,2.93636363636364,-3.98181818181818,10,9,6,19,44
"1545",2018-03-25,60,51,9,0,-1.535,0,1172.1,2.83,-6.41,23,9,14,14,60
"1546",2018-03-26,50,40,10,0,4,0,700,7.15,0.85,10,7,20,13,50
"1547",2018-03-27,58,42,16,3.86896551724138,4.93103448275862,0,758,6.95172413793104,2.91034482758621,5,5,22,26,58
"1548",2018-03-28,49,43,6,0,5.3530612244898,0,619.7,8.1265306122449,2.56734693877551,5,10,12,22,49
"1549",2018-03-29,65,53,12,14.8046153846154,5.35692307692308,0,821.8,7.22153846153846,3.39230769230769,4,11,33,17,65
"1550",2018-03-30,61,52,9,0.221311475409836,2.97377049180328,0,916.6,5.77377049180328,0.173770491803279,17,13,15,16,61
"1551",2018-03-31,74,65,9,2.7472972972973,4.3527027027027,0,1009.9,8.23378378378379,0.381081081081081,22,9,24,19,74
"1552",2018-04-01,93,88,5,0.16989247311828,1,0,1581,4.48494623655914,-2.56989247311828,29,18,24,22,93
"1553",2018-04-02,48,43,5,0,2.6,0,739.2,6.36666666666667,-1.26666666666667,9,7,19,13,48
"1554",2018-04-03,60,50,10,17.98,3.69333333333333,0,858.4,5.00666666666667,2.37333333333333,12,3,22,23,60
"1555",2018-04-04,51,42,9,4.70588235294118,1.28823529411765,0,852.3,5.66470588235294,-3.18823529411765,4,9,25,13,51
"1556",2018-04-05,62,52,10,0.190322580645161,-0.5,0,1147,2.89516129032258,-3.89516129032258,7,10,24,21,62
"1557",2018-04-06,58,53,5,1.4,1.4,0,962.8,5.36896551724138,-2.56896551724138,7,10,26,15,58
"1558",2018-04-07,58,41,17,0,-1.20862068965517,0,1114.1,1.97413793103448,-4.39137931034483,12,10,13,23,58
"1559",2018-04-08,48,41,7,0,-0.520833333333333,0,889,2.64791666666667,-3.58958333333333,11,3,17,17,48
"1560",2018-04-09,47,42,5,0.187234042553192,2.69574468085106,0,719.3,5.52765957446809,-3.5936170212766,12,6,16,13,47
"1561",2018-04-10,51,39,12,0,2.35294117647059,0,798,5.71764705882353,-1.01176470588235,3,11,21,16,51
"1562",2018-04-11,90,81,9,0.912222222222222,3.23888888888889,0,1328.5,5.37555555555556,1.09,13,9,26,30,78
"1563",2018-04-12,73,60,13,2.12328767123288,7.12191780821918,0,794.1,13.3041095890411,0.926027397260274,8,9,23,20,60
"1564",2018-04-13,69,64,5,5.25652173913044,4.43913043478261,0,935.7,5.96521739130435,2.81304347826087,11,6,31,21,69
"1565",2018-04-14,56,49,7,22.2875,0.492857142857143,0,980.4,4.69285714285714,-3.73035714285714,12,10,15,19,56
"1566",2018-04-15,39,36,3,35.1307692307692,-0.764102564102564,0,731.8,1.41794871794872,-2.84615384615385,9,8,12,10,39
"1567",2018-04-16,51,46,5,28.4862745098039,2.56862745098039,0,787,3.87450980392157,1.16274509803922,10,9,14,18,51
"1568",2018-04-17,47,38,9,0.697872340425532,0.587234042553191,0,818.4,2.01276595744681,-0.851063829787234,2,9,18,18,47
"1569",2018-04-18,49,47,2,0,2.9,0,739.9,4.7,1.02244897959184,8,9,14,18,49
"1570",2018-04-19,60,51,9,0,2.8,0,912,5.02,0.58,5,8,34,13,60
"1571",2018-04-20,66,54,12,0,4.03181818181818,0,921.9,8.62121212121212,-0.646969696969697,9,6,20,31,66
"1572",2018-04-21,56,47,9,0,6.7625,0,629.3,13.1928571428571,0.326785714285714,23,5,15,13,56
"1573",2018-04-22,62,53,9,0,8.89516129032258,0,564.5,14.7370967741935,2.95322580645161,19,3,22,18,62
"1574",2018-04-23,48,41,7,0,11.1395833333333,0,329.3,15.5458333333333,6.64375,9,4,16,19,48
"1575",2018-04-24,53,44,9,3.22830188679245,12.4698113207547,0,293.1,16.2264150943396,8.70754716981132,9,14,19,11,53
"1576",2018-04-25,54,48,6,16.3407407407407,7.55925925925926,0,563.8,10.6185185185185,4.42407407407407,1,9,16,16,42
"1577",2018-04-26,73,66,7,0.783561643835616,10.2178082191781,0,568.1,16.2246575342466,4.21095890410959,15,14,26,18,73
"1578",2018-04-27,92,83,9,1.41304347826087,9.93478260869565,0,742,13.7826086956522,6.08695652173913,11,15,28,19,73
"1579",2018-04-28,71,63,8,2.21267605633803,5.44507042253521,0,891.4,9.02253521126761,1.84507042253521,19,16,17,19,71
"1580",2018-04-29,54,52,2,0.174074074074074,5.9,0,653.4,11.1611111111111,0.638888888888889,15,5,18,16,54
"1581",2018-04-30,47,39,8,0,11.6957446808511,0,296.3,19.5063829787234,3.87021276595745,7,5,25,10,47
"1582",2018-05-01,106,94,12,0,15.5698113207547,0,257.6,22.888679245283,8.25094339622641,17,9,28,30,84
"1583",2018-05-02,67,61,6,0,19.0388059701493,1.97014925373134,62.4,24.455223880597,13.5223880597015,8,15,24,20,67
"1584",2018-05-03,59,56,3,4.83050847457627,16.8203389830508,0,69.6,22.5491525423729,11.0915254237288,12,14,19,14,59
"1585",2018-05-04,44,37,7,4.99090909090909,15.9454545454545,0,90.4,23.2727272727273,8.61818181818182,3,9,18,14,44
"1586",2018-05-05,52,44,8,0.296153846153846,15.8019230769231,0,114.3,23.4538461538462,8.13653846153846,20,8,13,11,52
"1587",2018-05-06,58,50,8,0.251724137931034,14.9172413793103,0,178.8,17.1586206896552,12.5931034482759,17,11,14,16,58
"1588",2018-05-07,74,63,11,0,13.1918918918919,0,355.8,15.8243243243243,10.4648648648649,6,6,29,33,74
"1589",2018-05-08,63,49,14,0,12.8285714285714,0,325.8,17.4698412698413,8.08730158730159,5,13,23,22,63
"1590",2018-05-09,77,66,11,0,16.8727272727273,0,86.8,22.6454545454545,11,15,5,22,35,77
"1591",2018-05-10,65,56,9,2.11384615384615,13.6,0,286,20.8584615384615,6.34153846153846,11,9,15,19,54
"1592",2018-05-11,61,56,5,0,8.40983606557377,0,585,10.4196721311475,6.3,5,9,20,27,61
"1593",2018-05-12,65,55,10,0,10.7061538461538,0,474.1,13.5138461538462,7.82,22,5,19,19,65
"1594",2018-05-13,74,61,13,0,11.9405405405405,0,448.4,16.1797297297297,7.67837837837838,23,11,16,24,74
"1595",2018-05-14,50,41,9,0,14.316,0,184.2,20.368,8.264,4,13,12,21,50
"1596",2018-05-15,46,44,2,18.8913043478261,16.7695652173913,0,56.6,21.304347826087,12.1347826086957,6,11,15,14,46
"1597",2018-05-16,68,59,9,0,14.9941176470588,0,204.4,19.9352941176471,10.0529411764706,8,13,30,17,68
"1598",2018-05-17,68,57,11,0,18.3941176470588,0.729411764705882,22.8,25.0382352941176,11.65,8,11,33,16,68
"1599",2018-05-18,73,60,13,0,13.1753424657534,0,352.2,15.727397260274,10.5328767123288,12,12,27,22,73
"1600",2018-05-19,66,58,8,11.6787878787879,11.7666666666667,0,411.4,14.7787878787879,8.73030303030303,22,8,25,11,66
"1601",2018-05-20,94,84,10,0.161702127659574,15.8127659574468,0,205.6,20.9234042553191,10.6212765957447,21,10,25,19,75
"1602",2018-05-21,76,66,10,0,15.0236842105263,0,226.2,21.2447368421053,8.72236842105263,15,9,23,29,76
"1603",2018-05-22,53,44,9,6.10377358490566,13.3943396226415,0,244.1,16.4603773584906,10.311320754717,6,15,15,17,53
"1604",2018-05-23,70,58,12,0,18.6842857142857,0.684285714285714,0,26.1628571428571,11.1057142857143,13,16,19,22,70
"1605",2018-05-24,58,53,5,0,20.4448275862069,2.4448275862069,0,27.748275862069,13.051724137931,14,12,13,19,58
"1606",2018-05-25,77,72,5,0,22.038961038961,4.06233766233766,1.8,27.7987012987013,16.2792207792208,12,15,19,31,77
"1607",2018-05-26,66,56,10,0,21.5818181818182,3.58181818181818,0,27.0727272727273,16.0909090909091,23,9,15,19,66
"1608",2018-05-27,63,55,8,0,21.1142857142857,3.31746031746032,12.8,26.1349206349206,16.0063492063492,18,7,16,22,63
"1609",2018-05-28,68,61,7,0,23.0441176470588,5.04411764705882,0,29.9676470588235,16.1205882352941,7,19,23,19,68
"1610",2018-05-29,68,57,11,0,22.1911764705882,4.19117647058824,0,25.2323529411765,19.1352941176471,5,12,22,29,68
"1611",2018-05-30,79,74,5,0,22.4974683544304,4.49746835443038,0,26.6848101265823,18.3037974683544,9,18,17,35,79
"1612",2018-05-31,63,56,7,3.27619047619048,24.1222222222222,6.12222222222222,0,28.2507936507937,19.9015873015873,7,7,23,26,63
"1613",2018-06-01,125,121,4,0,22.7616,4.7616,0,28.2576,17.2656,11,9,18,27,65
"1614",2018-06-02,77,68,9,0,17.0792207792208,0,70.9,19.9922077922078,14.0883116883117,30,8,21,18,77
"1615",2018-06-03,72,61,11,0.629166666666667,17.4013888888889,0,43.1,19.3708333333333,15.3319444444444,23,14,20,15,72
"1616",2018-06-04,68,62,6,0.5,16.5382352941176,0.0735294117647059,104.4,20.3941176470588,12.5235294117647,4,15,23,26,68
"1617",2018-06-05,43,38,5,0.3,13.7093023255814,0,184.5,16.0813953488372,11.246511627907,6,6,22,9,43
"1618",2018-06-06,83,66,17,0,13.7349397590361,0,354,16.4373493975904,10.9325301204819,18,11,26,28,83
"1619",2018-06-07,60,48,12,0,18.29,0.45,9.6,22.03,14.37,7,13,21,19,60
"1620",2018-06-08,78,61,17,0,18.4307692307692,0.507692307692308,6,22.1923076923077,14.5846153846154,6,16,23,33,78
"1621",2018-06-09,70,58,12,0,18.93,0.93,0,23.73,14.12,19,8,14,29,70
"1622",2018-06-10,49,47,2,0,17.5877551020408,0,20.2,20.4959183673469,14.6530612244898,19,9,12,9,49
"1623",2018-06-11,67,61,6,0,17.7,0,20.1,21.7119402985075,13.6014925373134,9,14,19,25,67
"1624",2018-06-12,44,36,8,0,19.6181818181818,1.61818181818182,0,25.9454545454545,13.2909090909091,6,12,7,19,44
"1625",2018-06-13,78,67,11,8,21.9833333333333,3.98333333333333,0,26.95,16.9333333333333,8,9,18,31,66
"1626",2018-06-14,67,57,10,0.17910447761194,20.1164179104478,2.11641791044776,0,24.4626865671642,15.7701492537313,6,17,27,17,67
"1627",2018-06-15,69,62,7,0,18.8753623188406,0.956521739130435,5.6,24.1565217391304,13.5739130434783,18,8,16,27,69
"1628",2018-06-16,50,45,5,0,20.996,2.996,0,27.296,14.696,17,7,6,20,50
"1629",2018-06-17,66,58,8,0,23.8272727272727,5.82727272727273,0,30.1606060606061,17.4151515151515,22,4,18,22,66
"1630",2018-06-18,67,58,9,17.5149253731343,26.1985074626866,8.19850746268657,0,32.8626865671642,19.4402985074627,10,7,29,21,67
"1631",2018-06-19,58,48,10,0,19.4293103448276,1.42931034482759,0,22.0344827586207,16.7241379310345,8,17,20,13,58
"1632",2018-06-20,52,38,14,0,19.7076923076923,1.70769230769231,0,23.2076923076923,16.1230769230769,14,6,11,21,52
"1633",2018-06-21,64,51,13,0,17.834375,0,10.6,20.3484375,15.2203125,10,12,22,20,64
"1634",2018-06-22,54,46,8,0.707407407407407,17.9925925925926,0.17037037037037,9.6,21.2592592592593,14.6259259259259,9,15,11,19,54
"1635",2018-06-23,63,57,6,7.13174603174603,17.3984126984127,0,37.9,18.8349206349206,15.9619047619048,18,4,14,27,63
"1636",2018-06-24,56,47,9,17.5214285714286,18.9571428571429,0.957142857142857,0,21.2285714285714,16.5928571428571,22,5,10,19,56
"1637",2018-06-25,57,50,7,0,18.659649122807,0.659649122807018,0,22.8315789473684,14.4701754385965,14,8,17,18,57
"1638",2018-06-26,63,52,11,0,17.9555555555556,0.0888888888888889,8.4,22.8333333333333,13.0666666666667,15,6,24,18,63
"1639",2018-06-27,65,55,10,7.20769230769231,18.6307692307692,0.646153846153846,1,20.1,17.0615384615385,13,10,18,24,65
"1640",2018-06-28,73,60,13,0,23.7630136986301,5.76301369863014,0,28.558904109589,18.8808219178082,10,5,32,26,73
"1641",2018-06-29,73,65,8,0,25.1356164383562,7.13561643835616,0,30.6945205479452,19.4904109589041,20,11,13,29,73
"1642",2018-06-30,64,64,0,0,25.9,7.9,0,31.15,20.625,20,10,21,13,64
"1643",2018-07-01,120,112,8,0,27.58,9.58,0,32.45,22.7,11,11,25,19,66
"1644",2018-07-02,61,56,5,0,26.3508196721311,8.35081967213115,0,31.4032786885246,21.1983606557377,11,17,9,24,61
"1645",2018-07-03,77,63,14,0,24.2454545454545,6.24545454545455,0,29.5142857142857,18.9688311688312,7,16,30,24,77
"1646",2018-07-04,60,49,11,0,26.52,8.52,0,31.62,21.34,12,6,24,18,60
"1647",2018-07-05,79,72,7,7.63670886075949,27.2607594936709,9.26075949367089,0,32.746835443038,21.6746835443038,7,13,24,35,79
"1648",2018-07-06,52,45,7,0,20.8153846153846,2.81538461538462,0,24.3192307692308,17.2923076923077,11,3,17,21,52
"1649",2018-07-07,63,57,6,0,20.5301587301587,2.53015873015873,0,25.5555555555556,15.4222222222222,16,13,10,24,63
"1650",2018-07-08,63,54,9,0,22.5492063492064,4.54920634920635,0,28.047619047619,16.9634920634921,23,6,12,22,63
"1651",2018-07-09,46,40,6,0,24.395652173913,6.39565217391304,0,31.6065217391304,17.1782608695652,7,6,15,18,46
"1652",2018-07-10,59,48,11,0,25.4322033898305,7.43220338983051,0,30.3915254237288,20.3728813559322,5,13,20,21,59
"1653",2018-07-11,49,41,8,0,22.4142857142857,4.41428571428571,0,26.6428571428571,18.0857142857143,6,5,12,26,49
"1654",2018-07-12,72,63,9,0,22.7333333333333,4.73333333333333,0,27.1777777777778,18.4555555555556,15,11,17,29,72
"1655",2018-07-13,66,58,8,0,23.1575757575758,5.15757575757576,0,30.3121212121212,18.9575757575758,5,11,16,34,66
"1656",2018-07-14,75,60,15,0,23.116,5.116,0,27.108,19.252,26,11,17,21,75
"1657",2018-07-15,70,59,11,0,23.0714285714286,5.07142857142857,0,30.4371428571429,18.8542857142857,18,8,18,26,70
"1658",2018-07-16,70,57,13,0.9,23.2985714285714,5.29857142857143,0,27.6857142857143,19.0728571428571,19,17,7,27,70
"1659",2018-07-17,60,51,9,0,23.57,5.57,0,28.52,18.705,17,11,15,17,60
"1660",2018-07-18,67,58,9,0,20.5,2.5,0,23.7358208955224,17.2492537313433,17,13,21,16,67
"1661",2018-07-19,67,53,14,0,21.5462686567164,3.54626865671642,0,27.0671641791045,15.9432835820896,13,17,24,13,67
"1662",2018-07-20,57,48,9,0,23.7210526315789,5.72105263157895,0,28.3982456140351,19.0438596491228,14,6,21,16,57
"1663",2018-07-21,58,49,9,0.862068965517241,21.8620689655172,3.86206896551724,0,25.148275862069,18.5758620689655,22,5,17,14,58
"1664",2018-07-22,63,50,13,21.1777777777778,20.431746031746,2.43174603174603,0,23.452380952381,17.4793650793651,20,8,14,21,63
"1665",2018-07-23,56,46,10,0,23.9017857142857,5.90178571428571,0,27.1678571428571,20.7178571428571,9,12,16,19,56
"1666",2018-07-24,54,46,8,16.9444444444444,25.5518518518519,7.55185185185185,0,29.2259259259259,21.8777777777778,8,7,19,20,54
"1667",2018-07-25,40,40,0,0,24.63,6.63,0,29.57,19.68,6,11,9,14,40
"1668",2018-07-26,49,35,14,0.0612244897959184,23.3632653061224,5.36326530612245,0,28.6163265306122,18.1979591836735,9,11,13,16,49
"1669",2018-07-27,55,48,7,0,22.5727272727273,4.57272727272727,0,26.6636363636364,18.4636363636364,15,9,12,19,55
"1670",2018-07-28,67,57,10,0,20.3671641791045,2.36716417910448,0,24.2865671641791,16.4477611940299,27,8,12,20,67
"1671",2018-07-29,52,49,3,0,20.425,2.425,0,26.075,14.85,20,7,11,14,52
"1672",2018-07-30,57,47,10,0,21.6736842105263,3.67368421052632,0,25.5684210526316,17.7789473684211,9,12,18,18,57
"1673",2018-07-31,56,44,12,0,22.1142857142857,4.11428571428571,0,24.6857142857143,19.4571428571429,6,9,15,26,56
"1674",2018-08-01,126,112,14,0,23.752380952381,5.75238095238095,0,26.2857142857143,21.3095238095238,11,9,18,32,70
"1675",2018-08-02,68,57,11,0,24.0602941176471,6.06029411764706,0,28.0088235294118,20.1558823529412,8,14,16,30,68
"1676",2018-08-03,62,51,11,0,24.2709677419355,6.27096774193548,0,27.9290322580645,20.6870967741935,14,17,14,17,62
"1677",2018-08-04,67,62,5,0,24.8223880597015,6.82238805970149,0,29.1791044776119,20.465671641791,22,9,9,27,67
"1678",2018-08-05,75,60,15,0,26.2266666666667,8.22666666666667,0,31.68,20.756,22,9,16,28,75
"1679",2018-08-06,43,36,7,11.2581395348837,26.5418604651163,8.54186046511628,0,31.506976744186,21.5511627906977,9,12,14,8,43
"1680",2018-08-07,48,35,13,59.375,23.6833333333333,5.68333333333333,0,27.825,19.5333333333333,7,10,14,17,48
"1681",2018-08-08,58,49,9,19.6413793103448,23.0655172413793,5.06551724137931,0,26.2931034482759,19.8379310344828,10,9,15,24,58
"1682",2018-08-09,59,54,5,2.16779661016949,23.6745762711864,5.67457627118644,0,29.6728813559322,17.5762711864407,8,12,15,24,59
"1683",2018-08-10,47,38,9,0,21.6297872340426,3.62978723404255,0,24.9914893617021,18.3085106382979,10,12,17,8,47
"1684",2018-08-11,71,64,7,0,21.7943661971831,3.7943661971831,0,26.4830985915493,17.1056338028169,25,8,14,24,71
"1685",2018-08-12,67,57,10,0,23.6462686567164,5.64626865671642,0,27.0940298507463,20.2731343283582,14,8,18,27,67
"1686",2018-08-13,51,42,9,0,24.0901960784314,6.09019607843137,0,27.3666666666667,20.8058823529412,4,6,20,21,51
"1687",2018-08-14,71,58,13,0,26.0802816901408,8.08028169014085,0,30.3408450704225,21.9098591549296,13,6,29,23,71
"1688",2018-08-15,61,55,6,0,26.3540983606557,8.35409836065574,0,31.6098360655738,21.0803278688525,10,15,16,20,61
"1689",2018-08-16,67,60,7,0.107462686567164,25.1686567164179,7.16865671641791,0,28.7731343283582,21.4641791044776,11,13,29,14,67
"1690",2018-08-17,65,50,15,27.0907692307692,24.4430769230769,6.44307692307692,0,27.4184615384615,21.4615384615385,8,16,22,19,65
"1691",2018-08-18,79,71,8,0,22.2164556962025,4.21645569620253,0,24.3848101265823,19.9481012658228,21,12,24,22,79
"1692",2018-08-19,92,78,14,0,21.5695652173913,3.5695652173913,0,24.3391304347826,18.8,11,11,10,32,64
"1693",2018-08-20,61,47,14,0,22.5,4.5,0,25.127868852459,19.872131147541,12,11,26,12,61
"1694",2018-08-21,71,55,16,39.243661971831,23.0633802816901,5.06338028169014,0,25.8507042253521,20.2633802816901,18,12,17,24,71
"1695",2018-08-22,42,39,3,0.2,19.247619047619,1.24761904761905,0,22.2,16.3761904761905,4,4,14,20,42
"1696",2018-08-23,57,45,12,0,21.5140350877193,3.5140350877193,0,27.2578947368421,15.7701754385965,8,8,14,27,57
"1697",2018-08-24,55,49,6,0,21.8,3.8,0,26.5036363636364,16.9963636363636,14,8,13,20,55
"1698",2018-08-25,61,49,12,8.75081967213115,22.7180327868852,4.71803278688525,0,25.0688524590164,20.3508196721311,15,10,15,21,61
"1699",2018-08-26,70,65,5,0,24.6714285714286,6.67142857142857,0,29.1357142857143,20.1285714285714,18,9,18,25,70
"1700",2018-08-27,58,42,16,3.05862068965517,23.8896551724138,5.88965517241379,0,26.7310344827586,21.0344827586207,10,12,18,18,58
"1701",2018-08-28,55,47,8,0,27.68,9.68,0,32.1745454545455,23.0909090909091,15,11,14,15,55
"1702",2018-08-29,51,42,9,0,23.8,5.8,0,28.8509803921569,18.8294117647059,6,8,17,20,51
"1703",2018-08-30,63,50,13,0,17.6,0,25.2,19.252380952381,16.0222222222222,18,6,18,21,63
"1704",2018-08-31,61,53,8,0,20.0409836065574,2.04098360655738,0,22.7016393442623,17.2803278688525,13,5,20,23,61
"1705",2018-09-01,115,102,13,0,22.1539130434783,4.15391304347826,0,27.3591304347826,17.024347826087,11,9,17,19,56
"1706",2018-09-02,75,61,14,0,24.896,6.896,0,27.7,22.076,23,7,18,27,75
"1707",2018-09-03,59,46,13,0.135593220338983,26.7881355932203,8.78813559322034,0,31.4847457627119,22.1779661016949,11,6,23,19,59
"1708",2018-09-04,67,59,8,0,23.9686567164179,5.96865671641791,0,27.3134328358209,20.6985074626866,13,14,15,25,67
"1709",2018-09-05,51,49,2,0.588235294117647,26.9,8.9,0,31.9588235294118,21.8294117647059,3,10,19,19,51
"1710",2018-09-06,70,61,9,0.697142857142857,22.4642857142857,4.46428571428571,0,26.3357142857143,18.6671428571429,12,10,23,25,70
"1711",2018-09-07,43,34,9,0,20.4744186046512,2.47441860465116,0,23.5883720930233,17.4232558139535,9,7,10,17,43
"1712",2018-09-08,78,65,13,0,15.5692307692308,0,189.6,18.0153846153846,13.2076923076923,26,6,23,23,78
"1713",2018-09-09,46,40,6,0,14.1369565217391,0,177.7,16.5913043478261,11.6673913043478,14,7,14,11,46
"1714",2018-09-10,49,39,10,32.0673469387755,14.6367346938776,0,164.8,16.7612244897959,12.4244897959184,7,11,14,17,49
"1715",2018-09-11,41,35,6,0,17.8243902439024,0,7.2,20.3243902439024,15.2365853658537,5,4,18,14,41
"1716",2018-09-12,48,42,6,0,18.725,0.725,0,22.9625,14.3875,6,7,19,16,48
"1717",2018-09-13,54,43,11,0,21.1333333333333,3.13333333333333,0,24.4444444444444,17.8,11,9,14,20,54
"1718",2018-09-14,62,54,8,0,23.8822580645161,5.88225806451613,0,27.25,20.5854838709677,11,6,18,27,62
"1719",2018-09-15,72,54,18,0,25.0013888888889,7.00138888888889,0,28.3486111111111,21.6388888888889,15,11,12,34,72
"1720",2018-09-16,72,62,10,0,24.1222222222222,6.12222222222222,0,27.6,20.5444444444444,20,13,13,26,72
"1721",2018-09-17,68,57,11,0,23.1941176470588,5.19411764705882,0,26.1411764705882,20.2294117647059,3,9,25,19,56
"1722",2018-09-18,64,52,12,0,22.075,4.075,0,27.675,16.475,8,17,15,24,64
"1723",2018-09-19,80,66,14,0,17.99375,0,0.5,20.73125,15.34375,9,9,24,26,68
"1724",2018-09-20,59,55,4,0,17.5677966101695,0,25.5,19.6271186440678,15.5949152542373,3,12,22,22,59
"1725",2018-09-21,63,50,13,0,22.1301587301587,4.13015873015873,0,30.6412698412698,13.6126984126984,15,9,14,25,63
"1726",2018-09-22,49,38,11,0,13.6163265306122,0,214.8,16.434693877551,10.7816326530612,8,5,13,23,49
"1727",2018-09-23,61,53,8,0,14.0262295081967,0,242.4,18.5016393442623,9.62622950819672,26,6,14,15,61
"1728",2018-09-24,68,58,10,3.73088235294118,15.5823529411765,0,164.4,19.7617647058824,11.4823529411765,12,9,20,27,68
"1729",2018-09-25,48,41,7,12.8145833333333,18.7104166666667,0.710416666666667,0,21.36875,16.0416666666667,4,8,18,18,48
"1730",2018-09-26,59,49,10,0,17.3305084745763,0,39.5,22.5457627118644,12.2101694915254,12,10,22,15,59
"1731",2018-09-27,43,39,4,0,13.893023255814,0,176.6,17.3186046511628,10.4674418604651,6,7,18,12,43
"1732",2018-09-28,52,47,5,3.4,17.1269230769231,0,45.4,22.9596153846154,11.3807692307692,17,6,15,14,52
"1733",2018-09-29,64,50,14,0.34375,13.16875,0,309.2,16.6265625,9.696875,22,9,16,17,64
"1734",2018-09-30,75,64,11,8.34,11.748,0,468.9,13.616,9.88,17,7,23,28,75
"1735",2018-10-01,98,83,15,8.20816326530612,10.9612244897959,0,689.8,13.5071428571429,8.33061224489796,26,19,27,26,98
"1736",2018-10-02,44,40,4,9.325,12.0795454545455,0,260.5,14.0636363636364,10.0113636363636,10,5,19,10,44
"1737",2018-10-03,76,60,16,0,15.4263157894737,0,195.6,19.2210526315789,11.6315789473684,18,4,29,25,76
"1738",2018-10-04,62,51,11,9.75806451612903,15.3387096774194,0,165,22.1806451612903,8.57741935483871,13,16,15,18,62
"1739",2018-10-05,41,35,6,0,10.0365853658537,0,326.5,13.4975609756098,6.63658536585366,10,4,11,16,41
"1740",2018-10-06,70,62,8,1.78428571428571,13.6942857142857,0,301.4,17.0628571428571,10.2414285714286,19,8,24,19,70
"1741",2018-10-07,48,44,4,6.1875,13.8625,0,198.6,15.4625,12.25,18,7,10,13,48
"1742",2018-10-08,56,51,5,0,13.3785714285714,0,258.8,15.1196428571429,11.6982142857143,18,12,12,14,56
"1743",2018-10-09,70,56,14,0,20.09,2.09,0,26.1957142857143,14.0528571428571,13,13,16,28,70
"1744",2018-10-10,59,52,7,0,22.3627118644068,4.36271186440678,0,25.9271186440678,18.6983050847458,13,6,18,22,59
"1745",2018-10-11,58,51,7,0,15.5120689655172,0,144.3,22.1,8.91206896551724,8,13,21,16,58
"1746",2018-10-12,61,53,8,0.360655737704918,9.05901639344262,0,545.4,11.6983606557377,6.4,7,11,19,24,61
"1747",2018-10-13,60,56,4,1.23,7.475,0,631.5,10.405,4.46,14,12,19,15,60
"1748",2018-10-14,64,54,10,0,9.18125,0,564.4,14.0421875,4.2203125,25,3,19,17,64
"1749",2018-10-15,67,62,5,2.92238805970149,9.06268656716418,0,598.8,13.810447761194,4.31492537313433,3,19,31,14,67
"1750",2018-10-16,53,37,16,0,7.90566037735849,0,535,12.3962264150943,3.31509433962264,4,6,18,25,53
"1751",2018-10-17,52,42,10,0,6.04038461538462,0,621.9,9.95384615384615,2.04038461538462,6,8,23,15,52
"1752",2018-10-18,48,36,12,0,4.30833333333333,0,657.2,8.49166666666667,0.0333333333333333,11,11,14,12,48
"1753",2018-10-19,69,59,10,0,10.695652173913,0,504,14.595652173913,6.69565217391304,17,8,25,19,69
"1754",2018-10-20,52,48,4,0,8.33461538461539,0,502.6,12.6173076923077,4.11730769230769,12,14,15,11,52
"1755",2018-10-21,54,51,3,0,3.95,0,758.7,6.55,1.35,22,8,11,13,54
"1756",2018-10-22,56,46,10,0,7.26785714285714,0,601,10.7142857142857,3.74464285714286,7,10,19,20,56
"1757",2018-10-23,59,42,17,2.7728813559322,6.95762711864407,0,651.5,10.2,3.62372881355932,5,15,24,15,59
"1758",2018-10-24,75,69,6,0.256,4.52933333333333,0,1010.3,6.32933333333333,2.62933333333333,16,13,24,22,75
"1759",2018-10-25,60,46,14,0,5.39166666666667,0,756.5,7.875,2.81666666666667,18,8,20,14,60
"1760",2018-10-26,73,59,14,0,6.91780821917808,0,809,8.55616438356164,5.17945205479452,14,10,25,24,73
"1761",2018-10-27,66,56,10,6.98181818181818,4.23636363636364,0,908.4,6.91818181818182,1.47272727272727,22,8,19,17,66
"1762",2018-10-28,65,60,5,1.57692307692308,4.02461538461538,0,908.4,6.2,1.84923076923077,20,4,18,23,65
"1763",2018-10-29,65,58,7,0.4,5.92307692307692,0,785,9.14615384615385,2.6,10,9,31,15,65
"1764",2018-10-30,54,48,6,0.362962962962963,5.56296296296296,0,671.6,10.2814814814815,0.744444444444444,8,11,14,21,54
"1765",2018-10-31,103,73,30,10.6233009708738,9.60776699029126,0,864.4,13.3,6.00776699029126,10,12,25,19,66
"1766",2018-11-01,99,94,5,33.5111111111111,7.14242424242424,0,1074.9,8.90808080808081,5.37676767676768,32,16,26,25,99
"1767",2018-11-02,80,68,12,3.9,5.3,0,1016,6.2,4.375,4,14,32,30,80
"1768",2018-11-03,63,53,10,1.5047619047619,5.11428571428571,0,811.8,7.41904761904762,2.80952380952381,14,12,18,19,63
"1769",2018-11-04,56,50,6,0.160714285714286,4.24107142857143,0,770.5,7.51964285714286,0.8625,15,5,17,19,56
"1770",2018-11-05,62,45,17,0.251612903225806,2.95483870967742,0,932.8,5.04193548387097,1.47741935483871,7,11,27,17,62
"1771",2018-11-06,76,62,14,5.65526315789474,12.5263157894737,0,416,16.2802631578947,8.86315789473684,15,11,25,25,76
"1772",2018-11-07,60,52,8,0.5,7.6,0,624,10,5.2,2,18,18,22,60
"1773",2018-11-08,62,50,12,0.285483870967742,4.91935483870968,0,811,6.30967741935484,3.61935483870968,9,4,28,21,62
"1774",2018-11-09,74,64,10,11.8324324324324,3.73243243243243,0,1055.8,5.22162162162162,2.32162162162162,14,17,24,19,74
"1775",2018-11-10,82,62,20,0,0.94390243902439,0,1398.6,3.58780487804878,-1.78536585365854,22,13,21,26,82
"1776",2018-11-11,78,58,20,0,1.89615384615385,0,1256.1,4.63589743589744,-0.843589743589744,32,11,14,21,78
"1777",2018-11-12,54,42,12,1.2,4.08333333333333,0,751.5,6.23333333333333,1.93333333333333,13,17,16,8,54
"1778",2018-11-13,46,33,13,0.182608695652174,-0.0739130434782609,0,831.4,2.72608695652174,-2.79130434782609,11,4,21,10,46
"1779",2018-11-14,47,38,9,0,-1.66595744680851,0,924.3,0.768085106382979,-4,10,4,17,16,47
"1780",2018-11-15,60,51,9,11.1483333333333,-0.976666666666667,0,1138.6,1.31166666666667,-3.165,12,11,18,19,60
"1781",2018-11-16,59,51,8,7.01186440677966,2.03559322033898,0,941.9,3.3593220338983,0.611864406779661,7,8,21,23,59
"1782",2018-11-17,64,50,14,0.171875,0.8421875,0,1098.1,3.45625,-1.871875,19,8,14,23,64
"1783",2018-11-18,55,48,7,0,0.436363636363636,0,966,3.40909090909091,-2.53636363636364,18,7,11,19,55
"1784",2018-11-19,58,42,16,0,1.58275862068966,0,952.2,4.25689655172414,-1.00862068965517,7,8,23,20,58
"1785",2018-11-20,65,58,7,0.407692307692308,0.581538461538462,0,1132.2,3.12615384615385,-2.06307692307692,13,8,20,24,65
"1786",2018-11-21,61,53,8,0.177049180327869,-4.77704918032787,0,1389.4,2.2344262295082,-11.8770491803279,6,18,20,17,61
"1787",2018-11-22,67,63,4,0,-8.67164179104478,0,1787,-5.1,-12.2149253731343,7,17,26,17,67
"1788",2018-11-23,66,52,14,0,-0.766666666666667,0,1238.6,3.68333333333333,-5.11666666666667,12,10,22,22,66
"1789",2018-11-24,55,44,11,4.54909090909091,4.32363636363636,0,752.2,6.58545454545455,2.04909090909091,13,8,18,16,55
"1790",2018-11-25,72,62,10,0.0416666666666667,6.23333333333333,0,847.2,7.77916666666667,4.5875,31,8,12,21,72
"1791",2018-11-26,70,56,14,26.3214285714286,4.5,0,945,6.73571428571429,2.24285714285714,6,19,24,21,70
"1792",2018-11-27,67,60,7,1.1910447761194,0.941791044776119,0,1142.9,2.74179104477612,-0.87910447761194,10,6,28,23,67
"1793",2018-11-28,51,44,7,0.176470588235294,1.35882352941176,0,848.7,3.59411764705882,-0.876470588235294,6,11,18,16,51
"1794",2018-11-29,59,41,18,0,1.9728813559322,0,945.6,2.8864406779661,0.972881355932203,4,7,18,30,59
"1795",2018-11-30,66,55,11,0.181818181818182,1.99090909090909,0,1056.6,2.89090909090909,1.09090909090909,8,13,26,19,66
"1796",2018-12-01,124,113,11,3.69354838709677,2.71774193548387,0,1895,3.88225806451613,1.53548387096774,11,19,34,31,95
"1797",2018-12-02,56,51,5,11.3785714285714,7.34642857142857,0,596.6,10.7928571428571,3.8,18,2,17,19,56
"1798",2018-12-03,74,62,12,1.55945945945946,3.19864864864865,0,1095.3,7.35675675675676,-0.959459459459459,16,13,25,20,74
"1799",2018-12-04,61,54,7,0,-1.92622950819672,0,1215.5,0.00327868852459016,-3.75573770491803,10,8,23,20,61
"1800",2018-12-05,46,37,9,0,-1.21521739130435,0,883.9,2.1304347826087,-4.54565217391304,8,15,11,12,46
"1801",2018-12-06,54,43,11,0.174074074074074,-0.387037037037037,0,992.9,2.5,-3.17407407407407,8,9,18,19,54
"1802",2018-12-07,37,31,6,0.172972972972973,-5.04594594594595,0,852.7,-2.34594594594595,-7.65945945945946,3,6,11,17,37
"1803",2018-12-08,71,66,5,0.698591549295775,-1.93661971830986,0,1415.5,0.401408450704225,-4.27464788732394,25,7,24,15,71
"1804",2018-12-09,53,42,11,0,-1.6377358490566,0,1040.8,1.08301886792453,-4.3377358490566,15,9,17,12,53
"1805",2018-12-10,64,56,8,0,1,0,1088,1.9140625,0,3,16,15,30,64
"1806",2018-12-11,49,41,8,0,-0.491836734693878,0,906.1,1.21632653061224,-2.2,7,5,15,22,49
"1807",2018-12-12,65,59,6,0.193846153846154,0.835384615384615,0,1115.7,1.93538461538462,-0.364615384615385,4,9,23,29,65
"1808",2018-12-13,62,49,13,1.65483870967742,1.8,0,1004.4,3.55645161290323,0.129032258064516,8,14,22,18,62
"1809",2018-12-14,60,47,13,3.29,4.135,0,831.9,5.98,2.205,10,7,19,24,60
"1810",2018-12-15,55,52,3,0,3.09818181818182,0,819.6,4.64909090909091,1.63454545454545,17,6,8,24,55
"1811",2018-12-16,52,44,8,0.0865384615384615,0.952884615384615,0,886.45,3.11538461538462,-0.776923076923077,12,12,13,15,52
"1812",2018-12-17,56,47,9,0.0910714285714286,0.752678571428571,0,965.85,2.98928571428571,-1.0375,9,14,12,21,56
"1813",2018-12-18,64,55,9,0,-2.59375,0,1318,-0.1875,-5,8,13,28,15,64
"1814",2018-12-19,52,40,12,0,2.12307692307692,0,825.6,5.2,-0.953846153846154,4,8,25,15,52
"1815",2018-12-20,53,46,7,3.8,3.33018867924528,0,777.5,5.74716981132075,0.886792452830189,8,15,20,10,53
"1816",2018-12-21,55,45,10,12.5909090909091,3.00909090909091,0,824.5,6.19090909090909,-0.0909090909090909,13,11,17,14,55
"1817",2018-12-22,56,45,11,0,-0.3,0,1024.8,0.725,-1.4,24,8,10,14,56
"1818",2018-12-23,61,53,8,0.2,0.436065573770492,0,1071.4,1.83606557377049,-0.9,14,10,22,15,61
"1819",2018-12-24,51,41,10,0.368627450980392,0.707843137254902,0,881.9,2.42352941176471,-1.0078431372549,11,12,10,18,51
"1820",2018-12-25,55,52,3,0.181818181818182,-0.0818181818181818,0,994.5,1.29090909090909,-1.46363636363636,13,11,16,15,55
"1821",2018-12-26,56,44,12,0,-0.6,0,1041.6,3.1,-4.20357142857143,12,6,19,19,56
"1822",2018-12-27,51,45,6,4.67058823529412,-1.07647058823529,0,972.9,3.72941176470588,-5.80588235294118,7,7,22,15,51
"1823",2018-12-28,55,41,14,1.86,7.22,0,592.9,10.82,3.62,8,8,20,19,55
"1824",2018-12-29,52,43,9,0,-0.8,0,977.6,4.14230769230769,-5.66153846153846,16,13,8,15,52
"1825",2018-12-30,56,48,8,1.1625,-1.71964285714286,0,1104.3,1.46071428571429,-4.9,13,9,19,15,56
"1826",2018-12-31,46,33,13,13.6652173913043,2.51739130434783,0,712.2,6.14347826086957,-1.12173913043478,10,6,9,21,46
"1827",2019-01-01,122,116,6,0.4,-0.132786885245902,0,2212.2,6.2672131147541,-6.61639344262295,11,9,18,16,54
"1828",2019-01-02,49,41,8,2.78571428571429,-3.8,0,1068.2,0.571428571428571,-8.15714285714286,4,10,23,12,49
"1829",2019-01-03,49,36,13,0,0.512244897959184,0,856.9,1.51836734693878,-0.587755102040816,8,6,15,20,49
"1830",2019-01-04,45,37,8,0,4.42888888888889,0,610.7,7.58666666666667,1.25333333333333,10,4,17,14,45
"1831",2019-01-05,48,40,8,0,2.48333333333333,0,744.8,3.85,1.03333333333333,17,3,15,13,48
"1832",2019-01-06,53,46,7,0,-0.988679245283019,0,1006.4,4.82264150943396,-6.78867924528302,12,10,15,16,53
"1833",2019-01-07,37,30,7,2.42432432432432,-0.908108108108108,0,699.6,5.65945945945946,-7.56756756756757,3,8,14,12,37
"1834",2019-01-08,57,45,12,3.09824561403509,6.01228070175439,0,683.3,8.7,3.31228070175439,3,10,17,27,57
"1835",2019-01-09,51,39,12,0.872549019607843,-0.092156862745098,0,922.7,3.4,-3.4921568627451,9,7,17,18,51
"1836",2019-01-10,47,42,5,0,-6.86170212765957,0,1168.5,-3.47446808510638,-10.2489361702128,8,18,9,12,47
"1837",2019-01-11,56,43,13,0,-9.28571428571429,0,1528,-6.47142857142857,-12.1714285714286,5,10,25,16,56
"1838",2019-01-12,63,56,7,0,-5.68095238095238,0,1491.9,-4.12857142857143,-7.32380952380952,23,9,16,15,63
"1839",2019-01-13,57,49,8,0,-7.90350877192982,0,1476.5,-5.64210526315789,-10.1649122807018,32,8,11,6,57
"1840",2019-01-14,56,39,17,0,-3.98214285714286,0,1231,-1.14464285714286,-6.81071428571429,7,11,15,23,56
"1841",2019-01-15,56,53,3,0,-1.11428571428571,0,1070.4,0.857142857142857,-3.07142857142857,15,11,18,12,56
"1842",2019-01-16,55,42,13,0.698181818181818,-4.76181818181818,0,1251.9,0.238181818181818,-9.67454545454545,16,16,12,11,55
"1843",2019-01-17,52,38,14,0.176923076923077,-6.68846153846154,0,1283.8,-1.97692307692308,-11.3884615384615,7,8,16,21,52
"1844",2019-01-18,55,41,14,0.963636363636364,-3.89272727272727,0,1204.1,0.8,-8.67090909090909,14,2,20,19,55
"1845",2019-01-19,51,47,4,7.18039215686274,-11.9588235294118,0,1527.9,-8.47254901960784,-15.4313725490196,11,9,9,22,51
"1846",2019-01-20,48,34,14,2.32916666666667,-17.8375,0,1720.2,-14.1375,-21.4479166666667,12,6,22,8,48
"1847",2019-01-21,36,32,4,0,-16.1111111111111,0,1228,-10.9111111111111,-21.3888888888889,3,8,6,19,36
"1848",2019-01-22,45,42,3,0,-6.94666666666667,0,1122.6,1.02,-14.82,7,11,14,13,45
"1849",2019-01-23,52,46,6,10.7692307692308,2.62307692307692,0,799.6,5.43076923076923,-0.123076923076923,3,11,21,17,52
"1850",2019-01-24,74,61,13,4.11216216216216,0.887837837837838,0,1266.3,4.15135135135135,-2.37567567567568,10,8,28,28,74
"1851",2019-01-25,48,39,9,0.358333333333333,-6.25833333333333,0,1164.4,-2.24791666666667,-10.3583333333333,6,6,13,23,48
"1852",2019-01-26,49,41,8,0.179591836734694,-8.25918367346939,0,1286.7,-4.35918367346939,-12.2387755102041,15,9,6,19,49
"1853",2019-01-27,56,46,10,6.39285714285714,-7.70357142857143,0,1439.4,-2.41964285714286,-12.9875,17,11,11,17,56
"1854",2019-01-28,60,55,5,12.1333333333333,-10.4533333333333,0,1707.2,-2.74,-18.16,8,11,20,21,60
"1855",2019-01-29,42,35,7,2.95238095238095,-6.57142857142857,0,1032,0.923809523809524,-14.0619047619048,3,4,20,15,42
"1856",2019-01-30,40,34,6,0.19,-17.455,0,1418.2,-13.855,-21.05,8,9,10,13,40
"1857",2019-01-31,51,44,7,0,-16.821568627451,0,1775.9,-12.6392156862745,-21.0039215686275,6,10,20,15,51
"1858",2019-02-01,88,80,8,0.0318181818181818,-13.2159090909091,0,2747,-8.81136363636364,-17.6045454545455,20,13,32,23,88
"1859",2019-02-02,52,44,8,0.0307692307692308,-6.02307692307692,0,1249.2,1.34615384615385,-13.3769230769231,13,8,13,18,52
"1860",2019-02-03,64,55,9,0.04375,3.928125,0,900.6,7.4875,0.290625,13,10,21,20,64
"1861",2019-02-04,73,62,11,1.91780821917808,8.42739726027397,0,698.8,11.5849315068493,5.26027397260274,8,9,30,26,73
"1862",2019-02-05,47,40,7,0.2,1.96170212765957,0,753.8,9.40851063829787,-5.50425531914894,3,15,19,10,47
"1863",2019-02-06,35,28,7,10.6,-2.87714285714286,0,730.7,-0.388571428571429,-5.27714285714286,3,6,15,11,35
"1864",2019-02-07,65,54,11,0.889230769230769,1.80615384615385,0,1052.6,5.81230769230769,-2.21384615384615,3,13,18,31,65
"1865",2019-02-08,78,58,20,0.182051282051282,-1.45384615384615,0,1517.4,5.79230769230769,-8.69102564102564,15,12,19,32,78
"1866",2019-02-09,48,42,6,0,-5.875,0,1146,-2.975,-8.76666666666667,11,3,15,19,48
"1867",2019-02-10,42,35,7,0.278571428571429,-5.12142857142857,0,971.1,-2.55,-7.78571428571429,8,7,20,7,42
"1868",2019-02-11,60,52,8,0.618333333333333,-4.01166666666667,0,1320.7,-2.92333333333333,-5.08833333333333,8,9,19,24,60
"1869",2019-02-12,51,44,7,20.3,-2.14705882352941,0,1027.5,1.65294117647059,-5.94705882352941,7,10,14,20,51
"1870",2019-02-13,52,41,11,2.70769230769231,-1.36923076923077,0,1007.2,1.63076923076923,-4.35384615384615,8,12,15,17,52
"1871",2019-02-14,77,52,25,1.7025974025974,-0.858441558441558,0,1452.1,2.22077922077922,-3.84805194805195,11,12,25,29,77
"1872",2019-02-15,49,44,5,1.23877551020408,0.438775510204082,0,860.5,4.09591836734694,-3.15918367346939,8,10,17,14,49
"1873",2019-02-16,76,59,17,0.178947368421053,-4.94736842105263,0,1744,-2.17894736842105,-7.79473684210526,20,9,23,24,76
"1874",2019-02-17,58,49,9,0.506896551724138,-7.52241379310345,0,1480.3,-5.33793103448276,-9.60689655172414,13,7,15,23,58
"1875",2019-02-18,67,47,20,2.14776119402985,-7.96417910447761,0,1739.6,-4.38208955223881,-11.455223880597,13,8,15,31,67
"1876",2019-02-19,55,43,12,0,-7.40545454545455,0,1397.3,-2.43818181818182,-12.4618181818182,6,12,21,16,55
"1877",2019-02-20,63,51,12,2.42380952380952,-2.98571428571429,0,1322.1,0.9,-6.86190476190476,6,14,17,26,63
"1878",2019-02-21,42,39,3,0.171428571428571,1.7,0,684.6,4.35714285714286,-0.971428571428571,4,13,15,10,42
"1879",2019-02-22,54,45,9,0,0.561111111111111,0,941.7,3.28333333333333,-2.08703703703704,9,11,16,18,54
"1880",2019-02-23,60,51,9,0,0.236666666666667,0,1065.8,2.50833333333333,-2.035,15,4,16,25,60
"1881",2019-02-24,59,50,9,9.6271186440678,2.39830508474576,0,920.5,6.67966101694915,-1.96610169491525,31,8,13,7,59
"1882",2019-02-25,77,69,8,0.353246753246753,-4.26493506493506,0,1714.4,-1.85324675324675,-6.67662337662338,21,7,28,21,77
"1883",2019-02-26,53,42,11,0.173584905660377,-7.01320754716981,0,1325.7,-4.3188679245283,-9.79433962264151,2,6,26,19,53
"1884",2019-02-27,48,41,7,7.50625,-9.3125,0,1311,-6.85416666666667,-11.8416666666667,8,10,11,19,48
"1885",2019-02-28,60,47,13,0.18,-10.1,0,1686,-5.92,-14.36,5,7,23,25,60
"1886",2019-03-01,109,85,24,0,-3.77981651376147,0,2374,-0.0669724770642202,-7.49266055045872,23,11,33,19,86
"1887",2019-03-02,80,69,11,2.7575,-2.07625,0,1606.1,-0.2475,-3.82875,27,13,12,28,80
"1888",2019-03-03,60,52,8,0.34,-4.275,0,1336.5,-0.88,-7.655,16,12,17,15,60
"1889",2019-03-04,47,37,10,0.178723404255319,-9.02127659574468,0,1270,-6.2531914893617,-11.7787234042553,5,5,16,21,47
"1890",2019-03-05,34,32,2,0.182352941176471,-10.1823529411765,0,958.2,-7.41764705882353,-12.9470588235294,4,8,14,8,34
"1891",2019-03-06,55,51,4,0,-9.81818181818182,0,1530,-7.36363636363636,-12.1818181818182,6,14,22,13,55
"1892",2019-03-07,49,44,5,0,-7.7,0,1259.3,-4.38163265306122,-11.0183673469388,5,14,18,12,49
"1893",2019-03-08,49,39,10,0,-6.25714285714286,0,1188.6,-1.31428571428571,-11.1857142857143,4,9,17,19,49
"1894",2019-03-09,69,57,12,0.885507246376812,-2.37391304347826,0,1405.8,1.61449275362319,-6.43333333333333,17,10,23,19,69
"1895",2019-03-10,73,70,3,14.0547945205479,3.48493150684931,0,1059.6,5.81232876712329,1.2,17,15,20,21,73
"1896",2019-03-11,53,48,5,0,1,0,901,3.17169811320755,-1.1811320754717,10,11,15,17,53
"1897",2019-03-12,47,39,8,0.187234042553192,0.987234042553191,0,799.6,3.86170212765957,-1.98723404255319,5,6,14,22,47
"1898",2019-03-13,47,40,7,0,1.27446808510638,0,786.1,3.31489361702128,-0.674468085106383,9,4,16,18,47
"1899",2019-03-14,41,37,4,6.72439024390244,6.63170731707317,0,466.1,10.8219512195122,2.44146341463415,13,2,13,13,41
"1900",2019-03-15,61,60,1,0.770491803278689,5.79508196721311,0,744.5,10.3901639344262,1.2,12,11,25,13,61
"1901",2019-03-16,75,66,9,0.330666666666667,-0.334666666666667,0,1375.1,2.67866666666667,-3.33066666666667,27,9,17,22,75
"1902",2019-03-17,64,61,3,0.175,-1.05,0,1219.2,3.1625,-5.25,19,7,12,26,64
"1903",2019-03-18,62,53,9,0,1.45483870967742,0,1025.8,4.5758064516129,-1.76612903225806,14,8,20,20,62
"1904",2019-03-19,51,48,3,0.345098039215686,1.42156862745098,0,845.5,5.42156862745098,-2.57843137254902,6,10,18,17,51
"1905",2019-03-20,64,55,9,0,5.1609375,0,821.7,9.4953125,0.8265625,12,6,25,21,64
"1906",2019-03-21,49,40,9,0,5.55102040816327,0,610,7.93061224489796,3.07142857142857,6,11,20,12,49
"1907",2019-03-22,50,41,9,0.184,0.608,0,869.6,4.584,-3.376,8,10,17,15,50
"1908",2019-03-23,54,49,5,0.185185185185185,-0.0925925925925926,0,977,5.78518518518518,-5.87777777777778,9,3,12,30,54
"1909",2019-03-24,55,55,0,0,5.13272727272727,0,707.7,9.75090909090909,0.498181818181818,11,13,17,14,55
"1910",2019-03-25,50,45,5,0,-0.124,0,906.2,2.52,-2.76,6,10,19,15,50
"1911",2019-03-26,40,33,7,0,0.1875,0,712.5,3.2625,-2.8875,11,9,12,8,40
"1912",2019-03-27,65,61,4,0,3.93076923076923,0,914.5,7.72307692307692,0.230769230769231,8,14,23,20,65
"1913",2019-03-28,58,47,11,0.2,6.11206896551724,0,689.5,11.2275862068966,0.981034482758621,4,14,24,16,58
"1914",2019-03-29,65,56,9,0,8.06153846153846,0,646,11.3523076923077,4.77076923076923,5,10,23,27,65
"1915",2019-03-30,68,63,5,31.4058823529412,3.36764705882353,0,995,6.11911764705882,0.7,19,12,18,19,68
"1916",2019-03-31,76,64,12,7.44078947368421,-0.381578947368421,0,1397,2.25789473684211,-3.02105263157895,27,7,27,15,76
"1917",2019-04-01,101,97,4,0.258415841584158,-0.4,0,1858.4,3.56138613861386,-4.27524752475248,23,12,34,32,101
"1918",2019-04-02,66,61,5,0,4.73333333333333,0,875.6,8.66666666666667,0.8,4,12,27,23,66
"1919",2019-04-03,52,46,6,0,4.94230769230769,0,679,7.79615384615385,2,3,11,19,19,52
"1920",2019-04-04,77,66,11,0,2.63766233766234,0,1182.9,6.03636363636364,-0.768831168831169,11,9,26,17,63
"1921",2019-04-05,55,47,8,0,2.52727272727273,0,851,4.03636363636364,0.936363636363636,11,7,20,17,55
"1922",2019-04-06,70,62,8,0,8.34,0,676.2,13.16,3.52,6,10,24,30,70
"1923",2019-04-07,60,54,6,3.35,8.61666666666667,0,563,10.7666666666667,6.46666666666667,15,3,21,21,60
"1924",2019-04-08,60,57,3,0.92,10.84,0,429.6,16.28,5.48666666666667,7,12,21,20,60
"1925",2019-04-09,68,58,10,0,7.83382352941176,0,691.3,11.7279411764706,4.02647058823529,7,11,26,24,68
"1926",2019-04-10,50,44,6,0,4.344,0,682.8,6.988,1.6,4,14,16,16,50
"1927",2019-04-11,47,40,7,0.782978723404255,2.1,0,747.3,4.38723404255319,-0.187234042553192,14,7,14,12,47
"1928",2019-04-12,42,36,6,1.4,9.44761904761905,0,359.2,14.6142857142857,4.36190476190476,7,10,14,11,42
"1929",2019-04-13,61,50,11,0,10.5475409836066,0,454.6,16.4901639344262,4.58524590163934,17,10,19,15,61
"1930",2019-04-14,47,46,1,23.9702127659574,3.92978723404255,0,661.3,5.14468085106383,2.61489361702128,11,8,14,14,47
"1931",2019-04-15,56,48,8,0.0214285714285714,7.07857142857143,0,611.6,9.29821428571429,3.48214285714286,10,10,25,11,56
"1932",2019-04-16,42,40,2,0.0333333333333333,4.3,0,575.4,7.2,1.38333333333333,2,8,16,16,42
"1933",2019-04-17,51,43,8,0,7.83333333333333,0,518.5,13.0156862745098,2.55882352941176,5,10,18,18,51
"1934",2019-04-18,63,59,4,0.328571428571429,13.1095238095238,0,308.1,19.6047619047619,6.6952380952381,10,13,23,17,63
"1935",2019-04-19,51,46,5,18.3607843137255,10.2901960784314,0,393.2,14.8176470588235,5.66274509803922,16,2,16,17,51
"1936",2019-04-20,57,48,9,8.94035087719298,7.14912280701754,0,618.5,8.93508771929825,5.2859649122807,18,9,9,21,57
"1937",2019-04-21,69,64,5,0,8.92608695652174,0,626.1,11.1826086956522,6.6695652173913,21,12,20,16,69
"1938",2019-04-22,55,49,6,0,11.0181818181818,0,384,15.6454545454545,6.45454545454545,7,13,14,21,55
"1939",2019-04-23,51,46,5,3.08627450980392,10.7725490196078,0,368.6,14.7039215686275,6.82745098039216,4,9,20,18,51
"1940",2019-04-24,70,63,7,0,9.01,0,629.3,13.21,4.9,10,14,23,23,70
"1941",2019-04-25,52,42,10,0,8.23461538461538,0,507.8,11.8423076923077,4.62692307692308,9,13,20,10,52
"1942",2019-04-26,60,53,7,19.51,8.335,0,579.9,12.5333333333333,4.13666666666667,16,12,15,17,60
"1943",2019-04-27,53,46,7,0,5.08679245283019,0,684.4,8.44716981132076,1.81320754716981,14,7,12,20,53
"1944",2019-04-28,62,54,8,0,7.1,0,675.8,10.7935483870968,3.30645161290323,19,5,18,20,62
"1945",2019-04-29,65,53,12,0.476923076923077,4.31538461538462,0,889.5,6.52307692307692,2.19230769230769,10,7,29,19,65
"1946",2019-04-30,72,66,6,0.316666666666667,7.375,0,765,10.025,4.71666666666667,10,19,26,17,72
"1947",2019-05-01,79,65,14,15.3164556962025,7.04683544303797,0,865.3,8.90126582278481,5.18481012658228,22,8,25,24,79
"1948",2019-05-02,65,53,12,2.4,6.38,0,755.3,8.42,4.32,9,12,26,18,65
"1949",2019-05-03,84,70,14,11.1285714285714,8.62380952380952,0,787.6,11.5571428571429,5.77142857142857,15,10,31,28,84
"1950",2019-05-04,72,48,24,0.4,9.91111111111111,0,582.4,12.2833333333333,7.58333333333333,19,11,19,23,72
"1951",2019-05-05,76,71,5,0,11.5263157894737,0,492,16.0263157894737,7.00263157894737,24,5,28,19,76
"1952",2019-05-06,68,58,10,0,15.1411764705882,0,194.4,21.6764705882353,8.60588235294118,21,5,22,20,68
"1953",2019-05-07,57,52,5,2.45789473684211,10.3,0,438.9,13.5385964912281,6.98070175438597,2,15,22,18,57
"1954",2019-05-08,79,61,18,0,8.56835443037975,0,745.1,11.0544303797468,6.16962025316456,12,19,24,24,79
"1955",2019-05-09,53,36,17,6.13962264150943,11.7150943396226,0,333.1,15.8811320754717,7.54905660377358,7,7,22,17,53
"1956",2019-05-10,84,64,20,12.325,10.8083333333333,0,604.1,16.175,5.34166666666667,6,9,31,26,72
"1957",2019-05-11,68,59,9,0,8.19411764705882,0,666.8,12.4764705882353,3.82352941176471,24,8,16,20,68
"1958",2019-05-12,55,52,3,4.46,7.74,0,564.3,10.56,4.94,19,7,18,11,55
"1959",2019-05-13,52,46,6,7.80192307692308,6.29423076923077,0,608.7,7.78269230769231,4.80576923076923,6,7,18,21,52
"1960",2019-05-14,52,44,8,0.961538461538462,11.1,0,358.8,15.6576923076923,6.54230769230769,5,8,27,12,52
"1961",2019-05-15,44,41,3,5.83636363636364,13.7090909090909,0,188.8,20.8272727272727,6.67272727272727,8,6,18,12,44
"1962",2019-05-16,45,39,6,0.2,12.0577777777778,0,267.4,15.1333333333333,8.89777777777778,4,12,14,15,45
"1963",2019-05-17,69,64,5,0.0173913043478261,14.2086956521739,0,261.6,18.4608695652174,10.0478260869565,10,14,20,25,69
"1964",2019-05-18,53,46,7,0,12.0622641509434,0,314.7,15.5264150943396,8.58679245283019,19,11,9,14,53
"1965",2019-05-19,59,53,6,2.88813559322034,14.5203389830508,0,205.3,19.3830508474576,9.65762711864407,24,11,12,12,59
"1966",2019-05-20,65,58,7,0,13.2538461538462,0,308.5,19.0076923076923,7.5,18,9,21,17,65
"1967",2019-05-21,75,60,15,0,12.8173333333333,0,388.7,19.1,6.61733333333333,13,14,28,20,75
"1968",2019-05-22,73,64,9,0.0164383561643836,12.2506849315069,0,419.7,14.3150684931507,10.0698630136986,12,14,31,16,73
"1969",2019-05-23,57,48,9,0.0210526315789474,16.8894736842105,0,63.3,24.8157894736842,8.93157894736842,4,15,17,21,57
"1970",2019-05-24,77,68,9,0,16.538961038961,0,112.5,21.2454545454545,11.8909090909091,14,8,30,25,77
"1971",2019-05-25,68,62,6,22.6823529411765,15.2132352941176,0,189.5,19.7455882352941,10.6808823529412,23,5,18,22,68
"1972",2019-05-26,81,75,6,0,18.9432098765432,0.962962962962963,1.6,24.0592592592593,13.8074074074074,28,7,19,27,81
"1973",2019-05-27,74,62,12,0,17.8054054054054,0,14.4,23.1837837837838,12.427027027027,16,9,22,27,74
"1974",2019-05-28,55,52,3,2.78181818181818,11.2509090909091,0,371.2,13.4509090909091,9.13454545454545,13,6,29,7,55
"1975",2019-05-29,77,60,17,0.171428571428571,12.7142857142857,0,407,14.6857142857143,10.7428571428571,10,15,25,27,77
"1976",2019-05-30,51,44,7,0,16.0705882352941,0,98.4,21.0411764705882,11.0882352941176,7,11,24,9,51
"1977",2019-05-31,67,58,9,0,14.1880597014925,0,255.4,18.0283582089552,10.4402985074627,20,14,19,14,67
"1978",2019-06-01,103,93,10,0.029126213592233,16.7893203883495,0.0533980582524272,130.2,21.2941747572816,12.2378640776699,29,9,31,23,92
"1979",2019-06-02,64,51,13,2.7859375,15.72265625,0.14609375,155.1,21.3375,10.30078125,19,8,20,17,64
"1980",2019-06-03,61,45,16,0,13.1852459016393,0.0540983606557377,297,18.5918032786885,7.82295081967213,8,8,18,27,61
"1981",2019-06-04,55,49,6,0,12.8036363636364,0.06,289.1,16.6854545454545,9.06,5,12,20,18,55
"1982",2019-06-05,42,40,2,11.8714285714286,15.1642857142857,0.0785714285714286,122.4,18.4714285714286,11.9214285714286,7,7,14,14,42
"1983",2019-06-06,76,62,14,0,17.9657894736842,0.0921052631578947,9.6,21.6421052631579,14.2894736842105,5,9,18,26,58
"1984",2019-06-07,67,60,7,0,19.1014925373134,1.23283582089552,8.8,25.0940298507463,13.0208955223881,24,12,14,17,67
"1985",2019-06-08,80,72,8,0,18.9625,1.1375,14,23.0375,14.8875,19,12,20,29,80
"1986",2019-06-09,75,71,4,0,19.6666666666667,1.73066666666667,4.8,23.2533333333333,16.0013333333333,10,12,25,28,75
"1987",2019-06-10,70,63,7,25.8357142857143,16.6285714285714,0,96,20.5428571428571,12.7142857142857,13,11,33,13,70
"1988",2019-06-11,95,83,12,0.183157894736842,17.5326315789474,0,44.4,23.2326315789474,11.8242105263158,11,10,20,28,69
"1989",2019-06-12,79,64,15,0,15.8822784810127,0,167.3,20.8670886075949,10.8974683544304,12,9,18,29,68
"1990",2019-06-13,48,41,7,19.94375,15.0375,0,142.2,16.99375,13,9,14,14,11,48
"1991",2019-06-14,69,60,9,0,17.7521739130435,0,17.1,23.236231884058,12.1840579710145,16,16,18,19,69
"1992",2019-06-15,60,48,12,0.0666666666666667,17.2333333333333,0,46,19.9,14.5666666666667,16,10,18,16,60
"1993",2019-06-16,91,87,4,0,16.4648351648352,0.132967032967033,151.8,20.4461538461538,12.5923076923077,22,7,30,32,91
"1994",2019-06-17,88,77,11,0,18.0215909090909,0.276136363636364,22.4,21.1738636363636,14.8693181818182,9,7,18,32,66
"1995",2019-06-18,62,59,3,0,20.5266129032258,2.52661290322581,0,24.4790322580645,16.5185483870968,8,13,20,21,62
"1996",2019-06-19,70,59,11,0,20.4542857142857,2.45428571428571,0,24.8714285714286,16.0885714285714,10,10,29,21,70
"1997",2019-06-20,65,57,8,16,19.06,1.06,0,21.66,16.44,12,15,25,13,65
"1998",2019-06-21,67,64,3,0,19.5820895522388,1.58208955223881,0,24.0492537313433,15.0313432835821,11,13,26,17,67
"1999",2019-06-22,85,75,10,0,19.7741176470588,1.77411764705882,0,25.2964705882353,14.2517647058824,23,8,18,19,68
"2000",2019-06-23,79,61,18,0,20.0177215189873,2.01772151898734,0,25.7367088607595,14.1987341772152,23,9,17,30,79
"2001",2019-06-24,68,63,5,17.6764705882353,19.8352941176471,1.91470588235294,5.4,23.7941176470588,15.8764705882353,11,7,21,29,68
"2002",2019-06-25,70,63,7,0.252857142857143,21.4328571428571,3.43285714285714,0,26.0742857142857,16.7757142857143,4,12,23,31,70
"2003",2019-06-26,71,59,12,0.028169014084507,23.8591549295775,5.85915492957746,0,29.4718309859155,18.1605633802817,15,11,25,20,71
"2004",2019-06-27,71,61,10,0,22.9070422535211,4.90704225352113,0,28.2647887323944,17.6098591549296,10,7,26,28,71
"2005",2019-06-28,83,70,13,13.9180722891566,23.5614457831325,5.56144578313253,0,28.0855421686747,19.1156626506024,15,13,22,33,83
"2006",2019-06-29,81,75,6,0.446913580246914,23.9111111111111,5.91111111111111,0,28.6197530864198,19.2024691358025,24,11,20,26,81
"2007",2019-06-30,93,78,15,0,21.458064516129,3.45806451612903,0,25.0161290322581,17.9720430107527,21,13,25,34,93
"2008",2019-07-01,109,98,11,0,20.9587155963303,2.95871559633028,0,26.1688073394495,15.748623853211,11,19,21,19,70
"2009",2019-07-02,75,61,14,0,23.016,5.016,0,25.476,20.472,18,15,18,24,75
"2010",2019-07-03,62,58,4,0,24.0354838709677,6.03548387096774,0,28.1354838709677,19.841935483871,6,10,15,31,62
"2011",2019-07-04,49,38,11,0,23.784693877551,5.78469387755102,0,28.3744897959184,19.1510204081633,10,9,16,14,49
"2012",2019-07-05,83,73,10,0,25.833734939759,7.83373493975904,0,30.5024096385542,21.1493975903614,16,14,17,19,66
"2013",2019-07-06,85,73,12,0.127058823529412,25.3988235294118,7.39882352941176,0,29.0882352941176,21.62,11,13,18,20,62
"2014",2019-07-07,78,68,10,0.153846153846154,20.4076923076923,2.40769230769231,0,23.1230769230769,17.6923076923077,17,8,25,28,78
"2015",2019-07-08,74,59,15,0,20.4905405405405,2.49054054054054,0,25.1054054054054,15.8635135135135,17,14,20,23,74
"2016",2019-07-09,62,53,9,0,21.4693548387097,3.46935483870968,0,26.8677419354839,16.0709677419355,4,8,34,16,62
"2017",2019-07-10,78,73,5,0,22.9115384615385,4.91153846153846,0,28.7153846153846,17.1961538461538,12,14,27,25,78
"2018",2019-07-11,60,50,10,0.0333333333333333,23.6833333333333,5.68333333333333,0,29.6333333333333,17.65,10,17,15,18,60
"2019",2019-07-12,69,62,7,0,20.8260869565217,2.82608695652174,0,24.2115942028985,17.4260869565217,13,12,18,26,69
"2020",2019-07-13,59,50,9,16.9796610169492,22.5474576271186,4.54745762711864,0,27.9542372881356,17.1406779661017,12,15,12,20,59
"2021",2019-07-14,90,76,14,0,22.36,4.36,0,27.34,17.47,16,7,18,30,71
"2022",2019-07-15,68,59,9,0,21.4823529411765,3.48235294117647,0,26.8,16.1529411764706,17,7,22,22,68
"2023",2019-07-16,51,43,8,5.72941176470588,24.9901960784314,6.99019607843137,0,31.8490196078431,18.2176470588235,9,12,16,14,51
"2024",2019-07-17,67,54,13,19.2417910447761,24.9313432835821,6.93134328358209,0,28.0716417910448,21.7776119402985,11,11,21,24,67
"2025",2019-07-18,69,51,18,0,24.4449275362319,6.44492753623188,0,27.9768115942029,21.0202898550725,15,13,18,23,69
"2026",2019-07-19,62,55,7,0,26.2967741935484,8.29677419354839,0,29.9483870967742,22.5548387096774,14,9,17,22,62
"2027",2019-07-20,83,68,15,4.51927710843373,27.4963855421687,9.49638554216867,0,33.7530120481928,21.3084337349398,21,10,26,26,83
"2028",2019-07-21,96,80,16,0,24.5572916666667,6.55729166666667,0,29.0885416666667,20.0020833333333,11,6,22,34,73
"2029",2019-07-22,63,53,10,0.7,20.9460317460317,2.94603174603175,0,23.8460317460317,18.1333333333333,12,9,26,16,63
"2030",2019-07-23,81,63,18,0,21.6037037037037,3.6037037037037,0,26.2888888888889,16.9111111111111,12,8,16,19,55
"2031",2019-07-24,63,58,5,0,21.9111111111111,3.91111111111111,0,26.2238095238095,17.4984126984127,9,13,25,16,63
"2032",2019-07-25,76,67,9,0.802631578947368,21.7276315789474,3.72763157894737,0,27.2684210526316,16.1868421052632,16,16,19,25,76
"2033",2019-07-26,59,52,7,0,23.5559322033898,5.55593220338983,0,28.9152542372881,18.2881355932203,12,10,20,17,59
"2034",2019-07-27,73,59,14,1.84931506849315,23.5561643835616,5.55616438356164,0,28.2301369863014,18.9328767123288,21,8,27,17,73
"2035",2019-07-28,81,73,8,0,25.1469135802469,7.14691358024691,0,30.2395061728395,20.037037037037,24,13,17,27,81
"2036",2019-07-29,67,62,5,0.307462686567164,24.5432835820896,6.54328358208955,0,29.1835820895522,19.9029850746269,15,15,23,14,67
"2037",2019-07-30,68,60,8,23.9647058823529,23.5735294117647,5.57352941176471,0,27.9514705882353,19.1794117647059,16,14,14,24,68
"2038",2019-07-31,54,47,7,0,21.6111111111111,3.61111111111111,0,26.0444444444444,17.2555555555556,7,7,11,29,54
"2039",2019-08-01,75,66,9,0,21.7306666666667,3.73066666666667,0,25.8266666666667,17.7173333333333,22,10,24,19,75
"2040",2019-08-02,57,48,9,0,22.0157894736842,4.01578947368421,0,26.5631578947368,17.4526315789474,6,7,22,22,57
"2041",2019-08-03,80,66,14,0,22.47625,4.47625,0,28.08,16.85875,15,10,20,35,80
"2042",2019-08-04,75,65,10,0,22.06,4.06,0,25.22,18.98,23,14,14,24,75
"2043",2019-08-05,88,82,6,0,22.5636363636364,4.56363636363636,0,28.1181818181818,16.9090909090909,25,12,27,24,88
"2044",2019-08-06,60,48,12,5.07166666666667,22.8166666666667,4.81666666666667,0,25.905,19.7,12,9,18,21,60
"2045",2019-08-07,66,62,4,0,22.9742424242424,4.97424242424242,0,26.3393939393939,19.5833333333333,12,11,21,22,66
"2046",2019-08-08,47,45,2,4.13404255319149,22.3404255319149,4.34042553191489,0,26.6021276595745,18.1531914893617,8,8,11,20,47
"2047",2019-08-09,77,57,20,0,21.0948051948052,3.09480519480519,0,26.0142857142857,16.2558441558442,11,11,20,35,77
"2048",2019-08-10,62,58,4,0,20.0516129032258,2.05161290322581,0,25.2161290322581,14.8870967741935,16,5,14,27,62
"2049",2019-08-11,71,63,8,0,20.2676056338028,2.26760563380282,0,26.4352112676056,14.1,20,11,19,21,71
"2050",2019-08-12,70,54,16,0.2,23.5085714285714,5.50857142857143,0,27.5828571428571,19.4342857142857,11,19,18,22,70
"2051",2019-08-13,53,45,8,0,23.6830188679245,5.68301886792453,0,27.5283018867925,19.8377358490566,8,5,17,23,53
"2052",2019-08-14,57,45,12,0,21.7140350877193,3.7140350877193,0,25.1666666666667,18.2614035087719,9,11,19,18,57
"2053",2019-08-15,66,48,18,2.9030303030303,20.4166666666667,2.41666666666667,0,23.6409090909091,17.0924242424242,15,12,16,23,66
"2054",2019-08-16,66,59,7,0,20.9318181818182,2.93181818181818,0,24.1681818181818,17.7681818181818,15,14,15,22,66
"2055",2019-08-17,74,60,14,22.072972972973,22.3175675675676,4.31756756756757,0,25.8783783783784,18.8162162162162,14,12,22,26,74
"2056",2019-08-18,65,59,6,3.27230769230769,23.18,5.18,0,26.7615384615385,19.5892307692308,25,10,17,13,65
"2057",2019-08-19,63,50,13,0.2,23.4555555555556,5.45555555555556,0,28.4,18.5111111111111,5,13,17,28,63
"2058",2019-08-20,54,46,8,0,22.0240740740741,4.02407407407407,0,26.8037037037037,17.3259259259259,7,8,14,25,54
"2059",2019-08-21,59,49,10,1.19152542372881,24.9796610169492,6.97966101694915,0,29.628813559322,20.4101694915254,8,11,14,26,59
"2060",2019-08-22,63,57,6,0,21.4761904761905,3.47619047619048,0,25.3603174603175,17.684126984127,12,16,15,20,63
"2061",2019-08-23,66,56,10,0,18.7090909090909,0.709090909090909,0,22.8181818181818,14.6818181818182,10,2,25,29,66
"2062",2019-08-24,45,40,5,0,17.5777777777778,0.0444444444444444,21,21.6555555555556,13.5555555555556,15,5,12,13,45
"2063",2019-08-25,81,65,16,0,19.0160493827161,1.01604938271605,0,22.7530864197531,15.279012345679,24,13,20,24,81
"2064",2019-08-26,49,35,14,0,20.7,2.7,0,23.6714285714286,17.8,8,8,20,13,49
"2065",2019-08-27,56,45,11,12.4857142857143,20.1071428571429,2.10714285714286,0,21.9928571428571,18.3142857142857,6,12,14,24,56
"2066",2019-08-28,72,60,12,0.025,22.475,4.475,0,26.7125,18.1375,11,12,31,18,72
"2067",2019-08-29,62,51,11,0,20.6129032258065,2.61290322580645,0,24.5387096774194,16.6870967741935,22,7,14,19,62
"2068",2019-08-30,69,56,13,0,20.063768115942,2.06376811594203,0,24.8144927536232,15.3985507246377,20,10,19,20,69
"2069",2019-08-31,75,71,4,0,17.492,0,38.1,21.812,13.08,15,16,18,26,75
"2070",2019-09-01,89,78,11,0.107865168539326,17.9719101123595,0.0539325842696629,7.3,19.7359550561798,16.1898876404494,23,9,26,19,77
"2071",2019-09-02,55,50,5,0,20.3272727272727,2.32727272727273,0,23.6909090909091,17.0545454545455,15,10,16,14,55
"2072",2019-09-03,64,56,8,5.33125,18.8328125,0.8328125,0,22.6890625,15.065625,8,18,16,22,64
"2073",2019-09-04,43,40,3,0,17.8279069767442,0.013953488372093,8,21.6860465116279,13.8767441860465,3,11,18,11,43
"2074",2019-09-05,58,53,5,0,16.4637931034483,0,89.1,21.1672413793103,11.7603448275862,6,13,16,23,58
"2075",2019-09-06,72,66,6,0.538888888888889,17.0805555555556,0,66.2,20.8611111111111,13.3902777777778,13,16,21,22,72
"2076",2019-09-07,76,70,6,0,17.5105263157895,0,37.2,22.8105263157895,12.2736842105263,21,5,29,21,76
"2077",2019-09-08,55,50,5,0,15.2472727272727,0,151.4,18.5545454545455,12.0090909090909,23,5,13,14,55
"2078",2019-09-09,66,53,13,0,14.7,0,217.8,18.9257575757576,10.4636363636364,10,12,23,21,66
"2079",2019-09-10,65,54,11,14.2507692307692,18.1107692307692,0.110769230769231,0,23.2830769230769,12.9292307692308,7,10,27,21,65
"2080",2019-09-11,56,46,10,0.3875,22.8625,4.8625,0,27.5375,18.1875,13,9,22,12,56
"2081",2019-09-12,63,56,7,0.480952380952381,16.4936507936508,0,94.9,19.368253968254,13.6126984126984,12,10,17,24,63
"2082",2019-09-13,74,54,20,4.75945945945946,18.3135135135135,0.313513513513514,0,21.3189189189189,15.3945945945946,13,16,20,25,74
"2083",2019-09-14,56,49,7,0,19.2285714285714,1.22857142857143,0,22.7285714285714,15.7285714285714,13,4,15,24,56
"2084",2019-09-15,78,73,5,3.04358974358974,15.9384615384615,0,160.8,18.3384615384615,13.4384615384615,13,13,18,34,78
"2085",2019-09-16,68,59,9,0.0147058823529412,15.9073529411765,0,142.3,18.1367647058824,13.5779411764706,8,9,16,22,55
"2086",2019-09-17,63,50,13,0,17.5857142857143,0,26.1,22.6285714285714,12.4571428571429,17,6,20,20,63
"2087",2019-09-18,63,60,3,0,18.0777777777778,0.165079365079365,5.5,22.2031746031746,13.852380952381,6,9,20,28,63
"2088",2019-09-19,66,60,6,0,18.7242424242424,0.787878787878788,4.2,22.6030303030303,14.8454545454545,14,8,26,18,66
"2089",2019-09-20,65,52,13,0,19.1892307692308,1.18923076923077,0,24.0415384615385,14.2369230769231,15,15,19,16,65
"2090",2019-09-21,79,69,10,0,21.8987341772152,3.89873417721519,0,26.2911392405063,17.4886075949367,11,11,19,13,54
"2091",2019-09-22,59,45,14,0,24.5796610169492,6.57966101694915,0,29.4423728813559,19.8016949152542,18,12,9,20,59
"2092",2019-09-23,69,63,6,0.173913043478261,20.6579710144928,2.65797101449275,0,25.2724637681159,15.9434782608696,4,11,28,26,69
"2093",2019-09-24,47,44,3,0,18.2957446808511,0.295744680851064,0,22.2,14.2914893617021,4,5,17,21,47
"2094",2019-09-25,64,58,6,0,19.484375,1.484375,0,24.96875,14.0984375,6,15,26,17,64
"2095",2019-09-26,55,46,9,3.35272727272727,17,0,55,22.1545454545455,11.8454545454545,7,10,20,18,55
"2096",2019-09-27,67,58,9,0,16.3402985074627,0,111.2,21.9402985074627,10.8283582089552,14,13,22,18,67
"2097",2019-09-28,70,64,6,4.57857142857143,16.9,0,77,20.57,13.2114285714286,22,8,16,24,70
"2098",2019-09-29,62,51,11,0,12.5725806451613,0,336.5,14.6870967741935,10.458064516129,18,3,24,17,62
"2099",2019-09-30,83,75,8,0,14.6361445783133,0,279.2,16.9361445783133,12.421686746988,14,9,26,21,70
"2100",2019-10-01,83,70,13,9.18072289156627,22.2228915662651,4.22289156626506,0,29.0698795180723,15.2879518072289,18,14,31,20,83
"2101",2019-10-02,63,54,9,9.47460317460317,14.8920634920635,0,195.8,19.568253968254,10.115873015873,7,11,21,24,63
"2102",2019-10-03,55,45,10,2.20181818181818,10.8818181818182,0,391.5,12.5818181818182,9.18181818181818,9,8,21,17,55
"2103",2019-10-04,77,67,10,0,9.68311688311688,0,640.4,12.4207792207792,7.02467532467533,15,11,25,26,77
"2104",2019-10-05,86,74,12,0,11.0372093023256,0,598.8,14.5988372093023,7.53604651162791,25,9,16,19,69
"2105",2019-10-06,74,57,17,1.13378378378378,17.0445945945946,0,70.7,20.2851351351351,13.7891891891892,25,14,11,24,74
"2106",2019-10-07,47,37,10,0,13.963829787234,0,189.7,18.3127659574468,9.52765957446809,8,7,16,16,47
"2107",2019-10-08,56,44,12,0,12.875,0,287,17.3625,8.475,4,11,18,23,56
"2108",2019-10-09,73,62,11,0,13.2972602739726,0,343.3,16.8684931506849,9.78219178082192,8,16,26,23,73
"2109",2019-10-10,69,60,9,0,13.4724637681159,0,312.4,16.2710144927536,10.7449275362319,5,15,21,28,69
"2110",2019-10-11,61,43,18,0,15.6344262295082,0,144.3,17.8360655737705,13.3327868852459,6,8,26,21,61
"2111",2019-10-12,66,60,6,3.44545454545455,10.9939393939394,0,462.4,15.4757575757576,6.41212121212121,22,5,19,20,66
"2112",2019-10-13,56,51,5,0,11.2321428571429,0,379,16.6321428571429,5.82142857142857,14,5,19,18,56
"2113",2019-10-14,83,62,21,0,10.4481927710843,0,626.8,12.9,7.89638554216867,16,15,26,26,83
"2114",2019-10-15,47,44,3,0,9.71702127659574,0,389.3,14.4787234042553,4.95106382978723,5,8,22,12,47
"2115",2019-10-16,54,44,10,21.7166666666667,11.1666666666667,0,369,13.7833333333333,8.55,5,10,20,19,54
"2116",2019-10-17,62,53,9,0,8.41290322580645,0,594.4,9.21290322580645,7.60645161290323,9,12,22,19,62
"2117",2019-10-18,59,47,12,0,7.80169491525424,0,601.7,11.0220338983051,4.48135593220339,7,8,25,19,59
"2118",2019-10-19,70,58,12,0,7.64571428571429,0,724.8,11.9714285714286,3.29428571428571,14,13,19,24,70
"2119",2019-10-20,60,51,9,0,11.7133333333333,0,377.2,15.4316666666667,8.07333333333333,15,7,20,18,60
"2120",2019-10-21,74,60,14,0.360810810810811,11.8459459459459,0,455.4,14.6662162162162,9.11216216216216,6,15,33,20,74
"2121",2019-10-22,59,46,13,9.23389830508474,13.2423728813559,0,280.7,15.9338983050847,10.5423728813559,9,15,18,17,59
"2122",2019-10-23,73,63,10,0,11.227397260274,0,494.4,14.0109589041096,8.43835616438356,10,15,29,19,73
"2123",2019-10-24,69,55,14,0.0115942028985507,10.8521739130435,0,493.2,14.6347826086957,7.06376811594203,12,5,31,21,69
"2124",2019-10-25,73,56,17,0,9.06986301369863,0,651.9,11.4547945205479,6.68493150684932,17,12,20,24,73
"2125",2019-10-26,86,66,20,12.1337209302326,7.24651162790698,0,924.8,11.0348837209302,3.45232558139535,32,7,15,32,86
"2126",2019-10-27,58,48,10,34.1931034482759,11.7,0,365.4,14.048275862069,9.42586206896552,22,7,8,21,58
"2127",2019-10-28,63,49,14,0,11.5857142857143,0,404.1,15.9,7.27142857142857,11,15,23,14,63
"2128",2019-10-29,62,51,11,0.0387096774193548,12.4645161290323,0,343.2,15.7290322580645,9.18064516129032,8,12,24,18,62
"2129",2019-10-30,81,67,14,17.4333333333333,8.96666666666667,0,731.7,10.7444444444444,7.26666666666667,8,9,22,25,64
"2130",2019-10-31,77,56,21,24.2948051948052,9.18701298701299,0,678.6,12.8675324675325,5.50649350649351,7,14,21,35,77
"2131",2019-11-01,88,73,15,0.025,4.4125,0,1195.7,5.6,3.1375,30,9,25,24,88
"2132",2019-11-02,68,50,18,0.648529411764706,5.23088235294118,0,868.3,7.8,2.75147058823529,14,11,17,26,68
"2133",2019-11-03,60,52,8,0,4.59,0,804.6,6.8,2.38,22,3,26,9,60
"2134",2019-11-04,56,45,11,0.378571428571429,7.84642857142857,0,568.6,11.1821428571429,4.51071428571429,6,11,19,20,56
"2135",2019-11-05,65,51,14,0,6.65692307692308,0,737.3,10.2076923076923,3.1,11,11,19,24,65
"2136",2019-11-06,56,49,7,0.4625,2.2625,0,881.3,4.9,-0.2875,12,11,21,12,56
"2137",2019-11-07,49,40,9,4.21836734693878,0.330612244897959,0,865.8,2.93061224489796,-2.26938775510204,7,10,16,16,49
"2138",2019-11-08,71,60,11,0,-2.02253521126761,0,1421.6,0.477464788732394,-4.42253521126761,11,12,18,30,71
"2139",2019-11-09,64,57,7,0,1.0546875,0,1084.5,4.4328125,-2.4234375,7,9,20,28,64
"2140",2019-11-10,45,35,10,0.155555555555556,3.74444444444444,0,641.5,7.72222222222222,-0.255555555555556,17,2,13,13,45
"2141",2019-11-11,50,35,15,13.71,-2.994,0,1049.7,0.106,-6.088,11,8,19,12,50
"2142",2019-11-12,51,41,10,0.176470588235294,-6.42941176470588,0,1245.9,-4.24117647058824,-8.61764705882353,2,5,24,20,51
"2143",2019-11-13,52,47,5,1.04615384615385,-5.52307692307692,0,1223.2,0.146153846153846,-11.1923076923077,4,14,12,22,52
"2144",2019-11-14,55,43,12,0.712727272727273,0.0563636363636364,0,986.9,1.65636363636364,-1.52909090909091,2,9,25,19,55
"2145",2019-11-15,60,44,16,0,-0.686666666666667,0,1121.2,3.98666666666667,-5.36,9,9,15,27,60
"2146",2019-11-16,50,37,13,0,-5.076,0,1153.8,-1.764,-8.388,19,6,8,17,50
"2147",2019-11-17,58,50,8,0,-0.279310344827586,0,1060.2,4,-4.57586206896552,20,4,11,23,58
"2148",2019-11-18,79,59,20,5.79240506329114,3.09620253164557,0,1177.4,3.88860759493671,2.3,8,19,25,27,79
"2149",2019-11-19,62,53,9,0,2.96774193548387,0,932,4.22741935483871,1.7,4,9,22,27,62
"2150",2019-11-20,68,62,6,0,5.1,0,877.2,8.44411764705882,1.83823529411765,10,9,18,16,53
"2151",2019-11-21,67,58,9,4.24626865671642,5.89253731343284,0,811.2,11.1328358208955,0.746268656716418,8,12,24,23,67
"2152",2019-11-22,82,67,15,0,5.45609756097561,0,1028.6,11.1975609756098,-0.385365853658537,20,12,18,15,65
"2153",2019-11-23,76,65,11,0,2.3,0,1193.2,5.46315789473684,-0.880263157894737,19,9,23,25,76
"2154",2019-11-24,60,52,8,0,2.88833333333333,0,906.7,6.73,-0.865,15,11,21,13,60
"2155",2019-11-25,59,50,9,0,4.95084745762712,0,769.9,7.61016949152542,2.27796610169492,12,19,10,18,59
"2156",2019-11-26,65,57,8,0,7.85230769230769,0,659.6,11.2261538461538,4.46923076923077,16,14,15,20,65
"2157",2019-11-27,57,47,10,5.91052631578947,7.77368421052632,0,582.9,10.1894736842105,5.42982456140351,8,12,22,15,57
"2158",2019-11-28,70,59,11,0,2.22571428571429,0,1104.2,6.62571428571429,-2.1,11,11,26,22,70
"2159",2019-11-29,62,55,7,0,-1.21612903225806,0,1191.4,-0.232258064516129,-2.28387096774194,8,16,19,19,62
"2160",2019-11-30,76,65,11,0,-1.78026315789474,0,1503.3,-0.467105263157895,-3.08684210526316,15,11,20,30,76
"2161",2019-12-01,54,50,4,12.6333333333333,-1.53333333333333,0,1054.8,0.0333333333333333,-3.08333333333333,19,7,11,17,54
"2162",2019-12-02,39,32,7,5.12051282051282,-1.94102564102564,0,777.7,-0.058974358974359,-3.74358974358974,5,9,17,8,39
"2163",2019-12-03,58,50,8,0.439655172413793,-2.4,0,1183.2,1.75172413793103,-6.55172413793103,7,12,22,17,58
"2164",2019-12-04,61,49,12,0.360655737704918,2.49016393442623,0,946.1,4.05081967213115,0.839344262295082,7,10,22,22,61
"2165",2019-12-05,45,40,5,0.177777777777778,0.422222222222222,0,791,1.55555555555556,-0.722222222222222,10,10,14,11,45
"2166",2019-12-06,64,53,11,6.33125,-1.1,0,1222.4,1.0765625,-3.1765625,14,11,20,19,64
"2167",2019-12-07,74,67,7,0,-1.7,0,1457.8,0.364864864864865,-3.76486486486486,21,10,23,20,74
"2168",2019-12-08,71,60,11,0,3.64788732394366,0,1019,7.37887323943662,-0.0830985915492958,17,5,30,19,71
"2169",2019-12-09,66,55,11,7.55,7.81363636363636,0,672.3,9.71818181818182,5.99545454545455,11,13,23,19,66
"2170",2019-12-10,51,46,5,0.380392156862745,2.50196078431373,0,790.4,10.5235294117647,-5.61960784313725,9,9,18,15,51
"2171",2019-12-11,46,34,12,0,-4.2,0,1021.2,-1.94565217391304,-6.43913043478261,4,11,18,13,46
"2172",2019-12-12,57,47,10,0,-2.76842105263158,0,1183.8,1.91578947368421,-7.54736842105263,7,13,18,19,57
"2173",2019-12-13,74,62,12,0,3.54054054054054,0,1070,5.47297297297297,1.59459459459459,11,18,18,27,74
"2174",2019-12-14,53,45,8,25.3981132075472,2.77358490566038,0,807,4.36037735849057,1.17358490566038,15,5,13,20,53
"2175",2019-12-15,64,59,5,0.14375,-0.571875,0,1188.6,2.6,-3.7875,25,7,13,19,64
"2176",2019-12-16,56,42,14,0,-1.17678571428571,0,1073.9,1.45357142857143,-3.86071428571429,12,17,15,12,56
"2177",2019-12-17,60,43,17,0,0.0233333333333333,0,1078.6,1.8,-1.67666666666667,14,8,12,26,60
"2178",2019-12-18,50,42,8,0.672,-7.784,0,1289.2,-1.4,-14.072,4,18,18,10,50
"2179",2019-12-19,56,41,15,1.32857142857143,-10.0553571428571,0,1571.1,-5.15535714285714,-14.9464285714286,10,12,14,20,56
"2180",2019-12-20,52,44,8,0.173076923076923,-5.80576923076923,0,1237.9,-2.9,-8.79807692307692,10,14,8,20,52
"2181",2019-12-21,57,49,8,0,-0.994736842105263,0,1082.7,2.66491228070175,-4.71929824561404,15,7,12,23,57
"2182",2019-12-22,48,40,8,0,3.45833333333333,0,698,6.19166666666667,0.716666666666667,19,5,11,13,48
"2183",2019-12-23,61,50,11,0,6.09508196721311,0,726.2,10.0852459016393,2.20327868852459,17,8,13,23,61
"2184",2019-12-24,44,41,3,0,1.20681818181818,0,738.9,2.64090909090909,-0.886363636363636,11,10,13,10,44
"2185",2019-12-25,33,29,4,0,1.43636363636364,0,546.6,2.87272727272727,0.0575757575757576,5,8,14,6,33
"2186",2019-12-26,62,55,7,0,3.19032258064516,0,918.2,4.75322580645161,1.67258064516129,9,2,17,34,62
"2187",2019-12-27,56,48,8,0,7.60178571428571,0,582.3,11.5214285714286,3.68214285714286,10,8,21,17,56
"2188",2019-12-28,73,67,6,0,3.6013698630137,0,1051.1,4.42328767123288,2.67945205479452,21,17,17,18,73
"2189",2019-12-29,54,45,9,7.01851851851852,2.24074074074074,0,851,3.28148148148148,1.18518518518519,20,4,12,18,54
"2190",2019-12-30,38,32,6,10.5394736842105,5.10789473684211,0,489.9,8.76052631578947,1.45526315789474,7,10,13,8,38
"2191",2019-12-31,47,39,8,1.47872340425532,1.41702127659574,0,779.4,3.2,-0.282978723404255,12,5,8,22,47
